STATE,TRACT,AREALAND,POP100,H001001,H002001,H002005,H003001,H003002,H003003,P001001,P002001,P002002,P002005,P003001,P003002,P003003,P003004,P003005,P003006,P003007,P003008,P003009,P003010,P003026,P003047,P003063,P003070,P004001,P004002,P004003,P012001,P012002,P012026,P012A001,state,county,tract
42,030101,0000054957843,00002528,973,973,0,973,914,59,2528,2528,0,0,2528,2507,2472,3,1,9,1,21,21,21,0,0,0,0,2528,47,2481,2528,1285,1243,2472,42,001,030101
42,030102,0000068781874,00005106,1982,1982,0,1982,1803,179,5106,5106,0,0,5106,5062,5017,9,12,9,1,14,44,44,0,0,0,0,5106,61,5045,5106,2560,2546,5017,42,001,030102
42,030200,0000121198606,00005080,1929,1929,0,1929,1802,127,5080,5080,0,0,5080,5022,4846,39,10,30,0,97,58,55,3,0,0,0,5080,333,4747,5080,2607,2473,4846,42,001,030200
42,030300,0000111834918,00003550,1451,1451,0,1451,1279,172,3550,3550,0,0,3550,3505,3299,40,7,2,1,156,45,43,2,0,0,0,3550,346,3204,3550,1799,1751,3299,42,001,030300
42,030400,0000179013088,00005438,2164,2164,0,2164,1980,184,5438,5438,0,0,5438,5386,5051,91,17,6,0,221,52,48,4,0,0,0,5438,400,5038,5438,2713,2725,5051,42,001,030400
42,030500,0000063850063,00003779,1484,1484,0,1484,1422,62,3779,3779,0,0,3779,3744,3590,25,10,5,0,114,35,33,2,0,0,0,3779,264,3515,3779,1874,1905,3590,42,001,030500
42,030600,0000089101427,00004539,1816,1816,0,1816,1687,129,4539,4539,0,0,4539,4498,4351,65,8,33,0,41,41,40,1,0,0,0,4539,104,4435,4539,2183,2356,4351,42,001,030600
42,030700,0000081911320,00005798,2195,2195,0,2195,2110,85,5798,5798,0,0,5798,5771,5670,37,6,22,0,36,27,27,0,0,0,0,5798,118,5680,5798,2885,2913,5670,42,001,030700
42,030800,0000058758189,00006132,2413,2413,0,2413,2297,116,6132,6132,0,0,6132,6103,5986,18,3,18,2,76,29,25,3,1,0,0,6132,163,5969,6132,3040,3092,5986,42,001,030800
42,030900,0000026848288,00006572,2478,2478,0,2478,2372,106,6572,6572,0,0,6572,6512,6197,46,10,26,7,226,60,51,3,6,0,0,6572,391,6181,6572,3112,3460,6197,42,001,030900
42,031000,0000008042424,00001345,493,493,0,493,483,10,1345,1345,0,0,1345,1336,1325,6,1,4,0,0,9,9,0,0,0,0,1345,3,1342,1345,667,678,1325,42,001,031000
42,031101,0000003114697,00005014,2154,2154,0,2154,2079,75,5014,5014,0,0,5014,4980,4900,29,7,8,1,35,34,30,4,0,0,0,5014,104,4910,5014,2377,2637,4900,42,001,031101
42,031102,0000017309519,00002041,773,773,0,773,741,32,2041,2041,0,0,2041,2027,1999,9,0,2,0,17,14,13,1,0,0,0,2041,27,2014,2041,992,1049,1999,42,001,031102
42,031201,0000067075113,00003232,1267,1267,0,1267,1191,76,3232,3232,0,0,3232,3210,3115,47,11,15,0,22,22,21,1,0,0,0,3232,64,3168,3232,1584,1648,3115,42,001,031201
42,031202,0000028283284,00002269,788,788,0,788,773,15,2269,2269,0,0,2269,2259,2242,4,2,8,1,2,10,10,0,0,0,0,2269,12,2257,2269,1125,1144,2242,42,001,031202
42,031203,0000045231607,00002989,1112,1112,0,1112,1074,38,2989,2989,0,0,2989,2972,2939,2,7,20,0,4,17,17,0,0,0,0,2989,25,2964,2989,1476,1513,2939,42,001,031203
42,031300,0000004061516,00003947,1692,1692,0,1692,1586,106,3947,3947,0,0,3947,3902,3839,22,4,17,0,20,45,44,1,0,0,0,3947,50,3897,3947,1875,2072,3839,42,001,031300
42,031401,0000029377531,00003423,1358,1358,0,1358,1295,63,3423,3423,0,0,3423,3400,3192,105,13,35,1,54,23,20,2,1,0,0,3423,102,3321,3423,1651,1772,3192,42,001,031401
42,031402,0000057252864,00002295,1007,1007,0,1007,936,71,2295,2295,0,0,2295,2272,2174,40,4,48,0,6,23,21,2,0,0,0,2295,21,2274,2295,1121,1174,2174,42,001,031402
42,031501,0000001503028,00002896,599,599,0,599,558,41,2896,2896,0,0,2896,2856,2635,61,15,37,1,107,40,39,1,0,0,0,2896,170,2726,2896,1366,1530,2635,42,001,031501
42,031502,0000002748965,00004594,2160,2160,0,2160,1983,177,4594,4594,0,0,4594,4456,3766,373,13,59,2,243,138,137,1,0,0,0,4594,431,4163,4594,2142,2452,3766,42,001,031502
42,031600,0000123306069,00006023,2400,2400,0,2400,2228,172,6023,6023,0,0,6023,5946,5856,29,17,24,1,19,77,76,1,0,0,0,6023,55,5968,6023,3012,3011,5856,42,001,031600
42,031700,0000103250900,00002702,1143,1143,0,1143,1059,84,2702,2702,0,0,2702,2679,2627,5,6,11,2,28,23,20,3,0,0,0,2702,32,2670,2702,1341,1361,2627,42,001,031700
42,010300,0000000963024,00003922,721,721,0,721,468,253,3922,3922,0,0,3922,3869,3075,522,12,147,4,109,53,50,3,0,0,0,3922,125,3797,3922,1601,2321,3075,42,003,010300
42,020100,0000001717785,00005222,1623,1623,0,1623,1264,359,5222,5222,0,0,5222,5165,2941,2071,8,107,2,36,57,51,4,2,0,0,5222,68,5154,5222,3582,1640,2941,42,003,020100
42,020300,0000001573136,00000266,195,195,0,195,128,67,266,266,0,0,266,260,97,162,0,0,0,1,6,6,0,0,0,0,266,9,257,266,126,140,97,42,003,020300
42,030500,0000000666954,00002724,1540,1540,0,1540,1396,144,2724,2724,0,0,2724,2701,288,2374,6,19,1,13,23,23,0,0,0,0,2724,18,2706,2724,1155,1569,288,42,003,030500
42,040200,0000000581844,00002272,638,638,0,638,536,102,2272,2272,0,0,2272,2238,922,1208,12,77,2,17,34,27,7,0,0,0,2272,37,2235,2272,1000,1272,922,42,003,040200
42,040300,0000000471111,00004439,106,106,0,106,100,6,4439,4439,0,0,4439,4377,3584,556,17,183,4,33,62,50,12,0,0,0,4439,56,4383,4439,1858,2581,3584,42,003,040300
42,040400,0000000453331,00002562,1875,1875,0,1875,1655,220,2562,2562,0,0,2562,2521,1880,74,1,543,0,23,41,36,4,1,0,0,2562,61,2501,2562,1208,1354,1880,42,003,040400
42,040500,0000000474523,00003010,1386,1386,0,1386,1257,129,3010,3010,0,0,3010,2922,2409,174,12,306,1,20,88,85,2,1,0,0,3010,73,2937,3010,1572,1438,2409,42,003,040500
42,040600,0000000233957,00002271,1169,1169,0,1169,1059,110,2271,2271,0,0,2271,2208,1808,142,4,238,0,16,63,62,1,0,0,0,2271,65,2206,2271,1287,984,1808,42,003,040600
42,040900,0000001394334,00003007,1558,1558,0,1558,1398,160,3007,3007,0,0,3007,2899,1892,851,2,129,4,21,108,100,6,0,2,0,3007,45,2962,3007,1569,1438,1892,42,003,040900
42,050100,0000000791491,00002143,1334,1334,0,1334,983,351,2143,2143,0,0,2143,2133,45,2075,5,2,0,6,10,9,1,0,0,0,2143,7,2136,2143,1015,1128,45,42,003,050100
42,050600,0000000809588,00002246,1171,1171,0,1171,1001,170,2246,2246,0,0,2246,2216,233,1949,7,13,1,13,30,21,9,0,0,0,2246,12,2234,2246,1010,1236,233,42,003,050600
42,050700,0000000384254,00002856,2022,2022,0,2022,1883,139,2856,2856,0,0,2856,2793,1956,401,3,412,2,19,63,54,8,1,0,0,2856,72,2784,2856,1405,1451,1956,42,003,050700
42,050900,0000000471057,00002109,1049,1049,0,1049,963,86,2109,2109,0,0,2109,2082,36,2023,12,0,1,10,27,17,10,0,0,0,2109,13,2096,2109,799,1310,36,42,003,050900
42,051000,0000000651815,00001250,1212,1212,0,1212,627,585,1250,1250,0,0,1250,1227,60,1156,2,8,0,1,23,18,4,1,0,0,1250,8,1242,1250,503,747,60,42,003,051000
42,051100,0000000179165,00001381,862,862,0,862,653,209,1381,1381,0,0,1381,1369,8,1353,3,0,0,5,12,5,7,0,0,0,1381,9,1372,1381,531,850,8,42,003,051100
42,060300,0000001052289,00002585,1448,1448,0,1448,1252,196,2585,2585,0,0,2585,2510,1866,583,3,50,1,7,75,67,7,1,0,0,2585,21,2564,2585,1250,1335,1866,42,003,060300
42,060500,0000000712719,00001488,928,928,0,928,778,150,1488,1488,0,0,1488,1450,1247,178,3,15,0,7,38,34,2,0,2,0,1488,28,1460,1488,695,793,1247,42,003,060500
42,070300,0000000420076,00002224,1286,1286,0,1286,1214,72,2224,2224,0,0,2224,2185,1874,131,5,153,1,21,39,29,10,0,0,0,2224,95,2129,2224,1130,1094,1874,42,003,070300
42,070500,0000000422950,00003138,1993,1993,0,1993,1884,109,3138,3138,0,0,3138,3063,2510,287,4,240,1,21,75,70,5,0,0,0,3138,97,3041,3138,1590,1548,2510,42,003,070500
42,070600,0000000297556,00001977,1330,1330,0,1330,1262,68,1977,1977,0,0,1977,1935,1659,63,3,185,1,24,42,42,0,0,0,0,1977,75,1902,1977,992,985,1659,42,003,070600
42,070800,0000000456609,00001667,1062,1062,0,1062,1006,56,1667,1667,0,0,1667,1636,1269,114,1,235,0,17,31,30,1,0,0,0,1667,61,1606,1667,846,821,1269,42,003,070800
42,070900,0000000783879,00004748,2780,2780,0,2780,2596,184,4748,4748,0,0,4748,4665,3247,393,7,919,9,90,83,79,4,0,0,0,4748,150,4598,4748,2365,2383,3247,42,003,070900
42,080200,0000000324494,00001828,1019,1019,0,1019,930,89,1828,1828,0,0,1828,1810,1740,44,2,15,0,9,18,17,1,0,0,0,1828,28,1800,1828,846,982,1740,42,003,080200
42,080400,0000000438055,00001413,934,934,0,934,791,143,1413,1413,0,0,1413,1394,1071,150,2,166,1,4,19,18,1,0,0,0,1413,10,1403,1413,700,713,1071,42,003,080400
42,080600,0000000402387,00002118,1319,1319,0,1319,1221,98,2118,2118,0,0,2118,2069,1760,196,2,91,1,19,49,46,3,0,0,0,2118,64,2054,2118,1056,1062,1760,42,003,080600
42,080700,0000000270864,00001791,1180,1180,0,1180,1072,108,1791,1791,0,0,1791,1723,1067,508,15,107,0,26,68,60,7,0,1,0,1791,33,1758,1791,924,867,1067,42,003,080700
42,080900,0000000381605,00001920,1141,1141,0,1141,1019,122,1920,1920,0,0,1920,1893,1519,280,6,67,0,21,27,25,1,1,0,0,1920,37,1883,1920,901,1019,1519,42,003,080900
42,090100,0000000672113,00001957,1186,1186,0,1186,959,227,1957,1957,0,0,1957,1939,1799,102,0,38,0,0,18,18,0,0,0,0,1957,4,1953,1957,918,1039,1799,42,003,090100
42,090200,0000001832942,00003149,1718,1718,0,1718,1543,175,3149,3149,0,0,3149,3120,2945,125,0,43,0,7,29,28,1,0,0,0,3149,25,3124,3149,1312,1837,2945,42,003,090200
42,090300,0000000249906,00001810,1019,1019,0,1019,885,134,1810,1810,0,0,1810,1780,1615,97,5,57,0,6,30,27,3,0,0,0,1810,23,1787,1810,830,980,1615,42,003,090300
42,100500,0000000699607,00002100,890,890,0,890,846,44,2100,2100,0,0,2100,2048,697,1330,0,14,0,7,52,44,8,0,0,0,2100,14,2086,2100,949,1151,697,42,003,100500
42,101100,0000001038546,00002899,1504,1504,0,1504,1235,269,2899,2899,0,0,2899,2859,2493,318,6,36,0,6,40,40,0,0,0,0,2899,28,2871,2899,1377,1522,2493,42,003,101100
42,101400,0000000955064,00003549,1679,1679,0,1679,1540,139,3549,3549,0,0,3549,3505,3123,351,2,11,0,18,44,43,1,0,0,0,3549,45,3504,3549,1598,1951,3123,42,003,101400
42,101600,0000000452809,00001879,855,855,0,855,619,236,1879,1879,0,0,1879,1853,64,1755,22,1,0,11,26,23,3,0,0,0,1879,14,1865,1879,754,1125,64,42,003,101600
42,101700,0000000382025,00002004,978,978,0,978,752,226,2004,2004,0,0,2004,1951,415,1431,2,88,0,15,53,39,10,4,0,0,2004,12,1992,2004,906,1098,415,42,003,101700
42,101800,0000001194487,00002742,1252,1252,0,1252,1196,56,2742,2742,0,0,2742,2711,2278,405,4,12,0,12,31,28,1,2,0,0,2742,19,2723,2742,1266,1476,2278,42,003,101800
42,110200,0000000789946,00004233,2247,2247,0,2247,2054,193,4233,4233,0,0,4233,4127,2559,1430,9,101,0,28,106,104,2,0,0,0,4233,79,4154,4233,1960,2273,2559,42,003,110200
42,110600,0000002093097,00002516,1149,1149,0,1149,1055,94,2516,2516,0,0,2516,2463,1852,561,1,26,1,22,53,49,4,0,0,0,2516,44,2472,2516,1166,1350,1852,42,003,110600
42,111300,0000000517692,00003188,1655,1655,0,1655,1409,246,3188,3188,0,0,3188,3103,780,2202,11,62,0,48,85,76,8,1,0,0,3188,33,3155,3188,1375,1813,780,42,003,111300
42,111400,0000000316843,00001567,748,748,0,748,594,154,1567,1567,0,0,1567,1506,115,1351,1,31,0,8,61,55,6,0,0,0,1567,21,1546,1567,765,802,115,42,003,111400
42,111500,0000000938240,00003683,2407,2407,0,2407,2076,331,3683,3683,0,0,3683,3596,698,2778,17,85,0,18,87,77,7,3,0,0,3683,45,3638,3683,1588,2095,698,42,003,111500
42,120100,0000002837354,00001684,436,436,0,436,405,31,1684,1684,0,0,1684,1638,358,1267,4,0,1,8,46,32,14,0,0,0,1684,26,1658,1684,901,783,358,42,003,120100
42,120200,0000000643380,00001632,824,824,0,824,710,114,1632,1632,0,0,1632,1598,20,1571,0,1,0,6,34,29,5,0,0,0,1632,15,1617,1632,707,925,20,42,003,120200
42,120300,0000001062255,00002234,1059,1059,0,1059,889,170,2234,2234,0,0,2234,2193,85,2086,10,5,0,7,41,32,8,1,0,0,2234,14,2220,2234,976,1258,85,42,003,120300
42,120400,0000000431769,00001274,653,653,0,653,487,166,1274,1274,0,0,1274,1237,72,1133,4,17,1,10,37,31,6,0,0,0,1274,21,1253,1274,537,737,72,42,003,120400
42,120700,0000000503733,00001114,583,583,0,583,462,121,1114,1114,0,0,1114,1097,33,1047,3,4,1,9,17,15,2,0,0,0,1114,10,1104,1114,530,584,33,42,003,120700
42,120800,0000000710143,00001328,775,775,0,775,518,257,1328,1328,0,0,1328,1313,149,1154,7,0,0,3,15,11,4,0,0,0,1328,16,1312,1328,568,760,149,42,003,120800
42,130100,0000000751112,00002637,1299,1299,0,1299,1038,261,2637,2637,0,0,2637,2597,38,2534,13,2,2,8,40,30,9,0,1,0,2637,31,2606,2637,1144,1493,38,42,003,130100
42,130200,0000000335147,00001885,872,872,0,872,702,170,1885,1885,0,0,1885,1862,15,1832,6,4,0,5,23,20,2,1,0,0,1885,5,1880,1885,826,1059,15,42,003,130200
42,130300,0000000555425,00001913,1160,1160,0,1160,918,242,1913,1913,0,0,1913,1879,20,1846,3,2,1,7,34,29,2,0,3,0,1913,22,1891,1913,787,1126,20,42,003,130300
42,130400,0000000481322,00001734,887,887,0,887,690,197,1734,1734,0,0,1734,1711,11,1690,3,2,0,5,23,19,4,0,0,0,1734,7,1727,1734,786,948,11,42,003,130400
42,130600,0000001390176,00003951,1890,1890,0,1890,1556,334,3951,3951,0,0,3951,3873,115,3706,12,9,0,31,78,53,16,1,8,0,3951,35,3916,3951,1645,2306,115,42,003,130600
42,140100,0000001460535,00005538,1117,1117,0,1117,1059,58,5538,5538,0,0,5538,5430,3899,184,13,948,8,378,108,105,3,0,0,0,5538,157,5381,5538,3359,2179,3899,42,003,140100
42,140200,0000000779772,00002435,1281,1281,0,1281,1191,90,2435,2435,0,0,2435,2378,1771,120,1,465,1,20,57,52,4,1,0,0,2435,52,2383,2435,1112,1323,1771,42,003,140200
42,140300,0000000955761,00003422,1571,1571,0,1571,1511,60,3422,3422,0,0,3422,3383,3113,88,1,163,1,17,39,39,0,0,0,0,3422,46,3376,3422,1645,1777,3113,42,003,140300
42,140400,0000000862130,00002356,1003,1003,0,1003,965,38,2356,2356,0,0,2356,2329,2206,47,4,61,0,11,27,26,1,0,0,0,2356,38,2318,2356,1102,1254,2206,42,003,140400
42,140500,0000000782899,00002304,1208,1208,0,1208,1057,151,2304,2304,0,0,2304,2253,634,1564,9,37,0,9,51,50,1,0,0,0,2304,27,2277,2304,1054,1250,634,42,003,140500
42,140600,0000001781180,00003309,1562,1562,0,1562,1476,86,3309,3309,0,0,3309,3255,2867,286,3,86,2,11,54,52,2,0,0,0,3309,42,3267,3309,1611,1698,2867,42,003,140600
42,140800,0000002391414,00004383,1998,1998,0,1998,1919,79,4383,4383,0,0,4383,4327,3940,118,4,231,1,33,56,53,3,0,0,0,4383,95,4288,4383,2177,2206,3940,42,003,140800
42,141000,0000000529037,00001131,562,562,0,562,543,19,1131,1131,0,0,1131,1117,1062,35,1,17,0,2,14,14,0,0,0,0,1131,9,1122,1131,509,622,1062,42,003,141000
42,141100,0000001334273,00001378,627,627,0,627,607,20,1378,1378,0,0,1378,1371,1335,22,0,9,0,5,7,7,0,0,0,0,1378,13,1365,1378,659,719,1335,42,003,141100
42,141300,0000002444006,00004950,2575,2575,0,2575,2468,107,4950,4950,0,0,4950,4886,4190,229,5,416,6,40,64,55,8,1,0,0,4950,134,4816,4950,2271,2679,4190,42,003,141300
42,141400,0000002085961,00005174,2496,2496,0,2496,2396,100,5174,5174,0,0,5174,5075,4557,150,6,326,0,36,99,97,2,0,0,0,5174,93,5081,5174,2428,2746,4557,42,003,141400
42,150100,0000002316165,00001948,999,999,0,999,838,161,1948,1948,0,0,1948,1922,1461,450,1,8,0,2,26,26,0,0,0,0,1948,14,1934,1948,916,1032,1461,42,003,150100
42,150400,0000001085645,00000805,287,287,0,287,270,17,805,805,0,0,805,786,192,583,9,1,0,1,19,18,1,0,0,0,805,6,799,805,255,550,192,42,003,150400
42,151500,0000001912311,00003386,1747,1747,0,1747,1451,296,3386,3386,0,0,3386,3335,1888,1385,11,23,0,28,51,43,8,0,0,0,3386,54,3332,3386,1526,1860,1888,42,003,151500
42,151600,0000000835078,00002608,1291,1291,0,1291,1184,107,2608,2608,0,0,2608,2596,2550,25,8,12,0,1,12,12,0,0,0,0,2608,18,2590,2608,1211,1397,2550,42,003,151600
42,151700,0000001185327,00005224,2582,2582,0,2582,2430,152,5224,5224,0,0,5224,5145,4762,178,10,164,1,30,79,71,8,0,0,0,5224,93,5131,5224,2498,2726,4762,42,003,151700
42,160300,0000001256639,00001999,880,880,0,880,805,75,1999,1999,0,0,1999,1984,1719,258,1,4,1,1,15,15,0,0,0,0,1999,7,1992,1999,957,1042,1719,42,003,160300
42,160400,0000000284363,00000238,557,557,0,557,116,441,238,238,0,0,238,234,47,185,1,0,0,1,4,3,1,0,0,0,238,2,236,238,89,149,47,42,003,160400
42,160600,0000000813573,00001453,768,768,0,768,440,328,1453,1453,0,0,1453,1427,190,1221,6,0,0,10,26,20,5,0,1,0,1453,17,1436,1453,575,878,190,42,003,160600
42,160700,0000000279432,00000584,246,246,0,246,216,30,584,584,0,0,584,578,464,113,1,0,0,0,6,6,0,0,0,0,584,0,584,584,272,312,464,42,003,160700
42,160800,0000001043166,00002961,1492,1492,0,1492,1326,166,2961,2961,0,0,2961,2921,2767,134,4,10,0,6,40,20,19,0,0,1,2961,17,2944,2961,1452,1509,2767,42,003,160800
42,160900,0000001299498,00002181,1378,1378,0,1378,1178,200,2181,2181,0,0,2181,2165,2055,87,5,13,0,5,16,16,0,0,0,0,2181,23,2158,2181,1027,1154,2055,42,003,160900
42,170200,0000001198690,00003545,2235,2235,0,2235,1956,279,3545,3545,0,0,3545,3501,3399,60,5,28,5,4,44,41,3,0,0,0,3545,51,3494,3545,1801,1744,3399,42,003,170200
42,170600,0000000798368,00002046,1088,1088,0,1088,934,154,2046,2046,0,0,2046,2030,1924,86,2,12,2,4,16,16,0,0,0,0,2046,19,2027,2046,1061,985,1924,42,003,170600
42,180300,0000000797404,00003220,1505,1505,0,1505,1302,203,3220,3220,0,0,3220,3154,2497,643,2,9,0,3,66,60,6,0,0,0,3220,22,3198,3220,1483,1737,2497,42,003,180300
42,180600,0000000799048,00000889,404,404,0,404,378,26,889,889,0,0,889,882,857,17,0,7,0,1,7,7,0,0,0,0,889,2,887,889,409,480,857,42,003,180600
42,180700,0000000378866,00002349,1085,1085,0,1085,989,96,2349,2349,0,0,2349,2332,1998,308,5,16,0,5,17,17,0,0,0,0,2349,16,2333,2349,1185,1164,1998,42,003,180700
42,180900,0000001096672,00002783,1298,1298,0,1298,1074,224,2783,2783,0,0,2783,2691,346,2288,15,17,3,22,92,69,23,0,0,0,2783,43,2740,2783,1287,1496,346,42,003,180900
42,190300,0000000816675,00002159,1258,1258,0,1258,1133,125,2159,2159,0,0,2159,2143,2080,42,4,7,0,10,16,16,0,0,0,0,2159,14,2145,2159,1044,1115,2080,42,003,190300
42,191100,0000001559716,00002696,1417,1417,0,1417,1276,141,2696,2696,0,0,2696,2654,2540,66,1,41,2,4,42,42,0,0,0,0,2696,17,2679,2696,1307,1389,2540,42,003,191100
42,191400,0000001024886,00003061,1728,1728,0,1728,1533,195,3061,3061,0,0,3061,3014,2798,180,9,17,1,9,47,44,3,0,0,0,3061,25,3036,3061,1500,1561,2798,42,003,191400
42,191500,0000000798262,00002309,1180,1180,0,1180,1064,116,2309,2309,0,0,2309,2286,2151,102,2,21,1,9,23,21,2,0,0,0,2309,24,2285,2309,1156,1153,2151,42,003,191500
42,191600,0000002458143,00004661,2120,2120,0,2120,1975,145,4661,4661,0,0,4661,4581,4155,354,11,35,0,26,80,77,3,0,0,0,4661,71,4590,4661,2232,2429,4155,42,003,191600
42,191700,0000001905704,00003634,1632,1632,0,1632,1558,74,3634,3634,0,0,3634,3602,3469,89,3,30,4,7,32,27,4,1,0,0,3634,28,3606,3634,1715,1919,3469,42,003,191700
42,191800,0000001461064,00005818,2545,2545,0,2545,2451,94,5818,5818,0,0,5818,5759,5628,52,6,59,0,14,59,55,4,0,0,0,5818,56,5762,5818,2676,3142,5628,42,003,191800
42,191900,0000000595822,00002447,1095,1095,0,1095,1024,71,2447,2447,0,0,2447,2416,2353,36,1,19,0,7,31,29,2,0,0,0,2447,25,2422,2447,1134,1313,2353,42,003,191900
42,192000,0000001385637,00004111,1928,1928,0,1928,1821,107,4111,4111,0,0,4111,4076,3832,148,8,52,2,34,35,35,0,0,0,0,4111,76,4035,4111,1911,2200,3832,42,003,192000
42,192100,0000000573931,00000056,40,40,0,40,30,10,56,56,0,0,56,53,38,13,0,0,0,2,3,3,0,0,0,0,56,0,56,56,29,27,38,42,003,192100
42,201600,0000000963630,00000530,233,233,0,233,231,2,530,530,0,0,530,524,509,9,0,1,0,5,6,6,0,0,0,0,530,9,521,530,251,279,509,42,003,201600
42,201700,0000000611508,00000495,231,231,0,231,189,42,495,495,0,0,495,489,395,87,3,1,0,3,6,6,0,0,0,0,495,2,493,495,219,276,395,42,003,201700
42,201800,0000001391313,00003053,1294,1294,0,1294,1146,148,3053,3053,0,0,3053,2983,2177,760,8,16,0,22,70,52,6,0,12,0,3053,26,3027,3053,1440,1613,2177,42,003,201800
42,201900,0000000554246,00000466,211,211,0,211,149,62,466,466,0,0,466,465,292,165,0,6,0,2,1,1,0,0,0,0,466,3,463,466,201,265,292,42,003,201900
42,202000,0000001609620,00002954,1415,1415,0,1415,1239,176,2954,2954,0,0,2954,2903,2406,437,8,15,1,36,51,46,5,0,0,0,2954,45,2909,2954,1414,1540,2406,42,003,202000
42,202100,0000000353700,00000595,238,238,0,238,232,6,595,595,0,0,595,591,150,431,1,0,0,9,4,4,0,0,0,0,595,3,592,595,274,321,150,42,003,202100
42,202200,0000000893252,00002996,1327,1327,0,1327,1239,88,2996,2996,0,0,2996,2945,2388,517,2,26,0,12,51,46,5,0,0,0,2996,29,2967,2996,1392,1604,2388,42,003,202200
42,202300,0000002576400,00004540,2203,2203,0,2203,2079,124,4540,4540,0,0,4540,4434,4055,158,4,200,1,16,106,101,5,0,0,0,4540,51,4489,4540,2168,2372,4055,42,003,202300
42,210700,0000000702750,00002506,1348,1348,0,1348,1084,264,2506,2506,0,0,2506,2463,303,2143,2,7,0,8,43,41,2,0,0,0,2506,16,2490,2506,1088,1418,303,42,003,210700
42,210800,0000001070674,00000039,29,29,0,29,27,2,39,39,0,0,39,37,13,24,0,0,0,0,2,2,0,0,0,0,39,0,39,39,20,19,13,42,003,210800
42,220100,0000000202266,00000508,390,390,0,390,308,82,508,508,0,0,508,502,385,105,2,7,0,3,6,6,0,0,0,0,508,11,497,508,296,212,385,42,003,220100
42,220400,0000000518350,00000886,675,675,0,675,465,210,886,886,0,0,886,872,458,386,4,17,1,6,14,12,2,0,0,0,886,11,875,886,445,441,458,42,003,220400
42,220500,0000001013662,00000270,251,251,0,251,154,97,270,270,0,0,270,261,226,23,0,12,0,0,9,9,0,0,0,0,270,3,267,270,177,93,226,42,003,220500
42,220600,0000000423658,00001938,1238,1238,0,1238,1001,237,1938,1938,0,0,1938,1896,1005,858,4,14,0,15,42,41,1,0,0,0,1938,44,1894,1938,1057,881,1005,42,003,220600
42,230400,0000000577916,00002635,1735,1735,0,1735,1396,339,2635,2635,0,0,2635,2587,1882,638,7,30,4,26,48,45,3,0,0,0,2635,44,2591,2635,1340,1295,1882,42,003,230400
42,240600,0000001124965,00002540,1415,1415,0,1415,1202,213,2540,2540,0,0,2540,2520,2471,33,2,7,2,5,20,20,0,0,0,0,2540,28,2512,2540,1215,1325,2471,42,003,240600
42,241200,0000000720175,00001254,621,621,0,621,517,104,1254,1254,0,0,1254,1226,1119,93,2,8,0,4,28,20,8,0,0,0,1254,4,1250,1254,592,662,1119,42,003,241200
42,250300,0000000246070,00001262,754,754,0,754,551,203,1262,1262,0,0,1262,1240,312,920,0,3,0,5,22,22,0,0,0,0,1262,8,1254,1262,615,647,312,42,003,250300
42,250700,0000000556540,00000973,450,450,0,450,384,66,973,973,0,0,973,952,190,757,1,0,1,3,21,21,0,0,0,0,973,14,959,973,444,529,190,42,003,250700
42,250900,0000000677951,00001751,856,856,0,856,746,110,1751,1751,0,0,1751,1703,828,859,4,4,0,8,48,33,9,6,0,0,1751,30,1721,1751,775,976,828,42,003,250900
42,260200,0000002444502,00002772,1226,1226,0,1226,1097,129,2772,2772,0,0,2772,2706,2174,491,5,25,0,11,66,59,6,1,0,0,2772,32,2740,2772,1312,1460,2174,42,003,260200
42,260700,0000000713083,00001897,890,890,0,890,788,102,1897,1897,0,0,1897,1857,1208,624,3,5,0,17,40,36,4,0,0,0,1897,23,1874,1897,922,975,1208,42,003,260700
42,260900,0000000771219,00002526,879,879,0,879,744,135,2526,2526,0,0,2526,2501,56,2427,5,0,0,13,25,19,6,0,0,0,2526,28,2498,2526,1009,1517,56,42,003,260900
42,261200,0000001118835,00001077,503,503,0,503,476,27,1077,1077,0,0,1077,1062,920,137,1,2,0,2,15,12,3,0,0,0,1077,6,1071,1077,494,583,920,42,003,261200
42,261400,0000001239870,00003293,1622,1622,0,1622,1273,349,3293,3293,0,0,3293,3228,955,2244,1,9,0,19,65,54,10,0,1,0,3293,31,3262,3293,1533,1760,955,42,003,261400
42,261500,0000001135934,00001983,990,990,0,990,814,176,1983,1983,0,0,1983,1919,698,1186,1,21,1,12,64,47,17,0,0,0,1983,25,1958,1983,891,1092,698,42,003,261500
42,262000,0000001574574,00003040,1392,1392,0,1392,1270,122,3040,3040,0,0,3040,3014,2325,679,1,6,0,3,26,22,4,0,0,0,3040,15,3025,3040,1368,1672,2325,42,003,262000
42,270100,0000001017714,00002868,1286,1286,0,1286,1158,128,2868,2868,0,0,2868,2840,2431,377,2,16,2,12,28,28,0,0,0,0,2868,12,2856,2868,1318,1550,2431,42,003,270100
42,270300,0000000604726,00002129,1049,1049,0,1049,931,118,2129,2129,0,0,2129,2091,1796,266,0,16,0,13,38,31,7,0,0,0,2129,14,2115,2129,957,1172,1796,42,003,270300
42,270400,0000001785377,00003026,599,599,0,599,529,70,3026,3026,0,0,3026,3003,1425,1492,7,6,0,73,23,17,6,0,0,0,3026,114,2912,3026,2340,686,1425,42,003,270400
42,270800,0000001276263,00003053,1329,1329,0,1329,1260,69,3053,3053,0,0,3053,3019,2799,197,0,9,0,14,34,32,2,0,0,0,3053,21,3032,3053,1392,1661,2799,42,003,270800
42,271500,0000001461581,00003925,1849,1849,0,1849,1599,250,3925,3925,0,0,3925,3844,3160,650,3,7,1,23,81,71,9,1,0,0,3925,21,3904,3925,1922,2003,3160,42,003,271500
42,280500,0000001106200,00000485,193,193,0,193,185,8,485,485,0,0,485,481,426,54,0,0,0,1,4,4,0,0,0,0,485,3,482,485,247,238,426,42,003,280500
42,280700,0000001023755,00001447,667,667,0,667,635,32,1447,1447,0,0,1447,1437,1017,404,0,9,2,5,10,10,0,0,0,0,1447,12,1435,1447,683,764,1017,42,003,280700
42,280800,0000002575799,00001099,644,644,0,644,386,258,1099,1099,0,0,1099,1060,61,989,1,4,4,1,39,36,3,0,0,0,1099,16,1083,1099,468,631,61,42,003,280800
42,281100,0000001739428,00003093,1499,1499,0,1499,1426,73,3093,3093,0,0,3093,3044,2823,135,3,68,0,15,49,49,0,0,0,0,3093,23,3070,3093,1458,1635,2823,42,003,281100
42,281200,0000000698316,00001028,551,551,0,551,523,28,1028,1028,0,0,1028,1016,953,38,1,16,0,8,12,12,0,0,0,0,1028,5,1023,1028,448,580,953,42,003,281200
42,281400,0000001347251,00002571,1102,1102,0,1102,1016,86,2571,2571,0,0,2571,2506,1630,846,10,8,0,12,65,57,7,1,0,0,2571,28,2543,2571,1164,1407,1630,42,003,281400
42,281500,0000000608996,00001628,717,717,0,717,667,50,1628,1628,0,0,1628,1607,1508,87,2,5,0,5,21,20,1,0,0,0,1628,11,1617,1628,794,834,1508,42,003,281500
42,290100,0000001273020,00002191,1070,1070,0,1070,960,110,2191,2191,0,0,2191,2168,2063,88,3,7,3,4,23,20,0,0,3,0,2191,9,2182,2191,1096,1095,2063,42,003,290100
42,290200,0000001456184,00004320,2045,2045,0,2045,1872,173,4320,4320,0,0,4320,4278,4190,66,5,15,1,1,42,39,2,0,1,0,4320,24,4296,4320,1984,2336,4190,42,003,290200
42,290400,0000001619779,00004174,1999,1999,0,1999,1839,160,4174,4174,0,0,4174,4142,4047,69,5,18,0,3,32,31,1,0,0,0,4174,27,4147,4174,1974,2200,4047,42,003,290400
42,300100,0000000791111,00004432,1923,1923,0,1923,1684,239,4432,4432,0,0,4432,4356,2784,1481,8,49,1,33,76,62,14,0,0,0,4432,41,4391,4432,2052,2380,2784,42,003,300100
42,310100,0000004555477,00000457,228,228,0,228,203,25,457,457,0,0,457,452,449,1,0,2,0,0,5,5,0,0,0,0,457,1,456,457,232,225,449,42,003,310100
42,310200,0000002519424,00003671,1619,1619,0,1619,1540,79,3671,3671,0,0,3671,3655,3623,18,2,11,0,1,16,12,2,2,0,0,3671,25,3646,3671,1756,1915,3623,42,003,310200
42,310300,0000002095221,00000937,387,387,0,387,374,13,937,937,0,0,937,920,812,88,18,2,0,0,17,12,5,0,0,0,937,7,930,937,476,461,812,42,003,310300
42,320400,0000000857953,00002244,953,953,0,953,901,52,2244,2244,0,0,2244,2234,2156,62,0,16,0,0,10,8,2,0,0,0,2244,6,2238,2244,1074,1170,2156,42,003,320400
42,320600,0000001469225,00002419,1077,1077,0,1077,1034,43,2419,2419,0,0,2419,2405,2308,74,1,17,0,5,14,14,0,0,0,0,2419,11,2408,2419,1130,1289,2308,42,003,320600
42,320700,0000001310516,00001797,773,773,0,773,738,35,1797,1797,0,0,1797,1779,1751,11,4,10,1,2,18,18,0,0,0,0,1797,22,1775,1797,880,917,1751,42,003,320700
42,401100,0000013218141,00004642,2138,2138,0,2138,2038,100,4642,4642,0,0,4642,4609,4516,70,1,20,0,2,33,31,2,0,0,0,4642,17,4625,4642,2203,2439,4516,42,003,401100
42,401200,0000002647034,00003458,1850,1850,0,1850,1559,291,3458,3458,0,0,3458,3399,3070,301,4,16,0,8,59,53,5,1,0,0,3458,38,3420,3458,1517,1941,3070,42,003,401200
42,401300,0000002968594,00002834,1258,1258,0,1258,1199,59,2834,2834,0,0,2834,2826,2781,33,1,9,0,2,8,8,0,0,0,0,2834,5,2829,2834,1335,1499,2781,42,003,401300
42,402000,0000001325252,00003543,1700,1700,0,1700,1507,193,3543,3543,0,0,3543,3515,3367,122,4,8,1,13,28,24,4,0,0,0,3543,19,3524,3543,1582,1961,3367,42,003,402000
42,403500,0000003224070,00004993,2556,2556,0,2556,2170,386,4993,4993,0,0,4993,4924,4683,182,14,30,2,13,69,55,14,0,0,0,4993,45,4948,4993,2339,2654,4683,42,003,403500
42,404000,0000005976002,00001362,682,682,0,682,606,76,1362,1362,0,0,1362,1348,1319,26,0,2,0,1,14,14,0,0,0,0,1362,1,1361,1362,613,749,1319,42,003,404000
42,405000,0000024279959,00001286,569,569,0,569,527,42,1286,1286,0,0,1286,1284,1280,1,0,2,0,1,2,2,0,0,0,0,1286,1,1285,1286,648,638,1280,42,003,405000
42,406000,0000033460199,00002504,1031,1031,0,1031,985,46,2504,2504,0,0,2504,2498,2472,5,1,17,1,2,6,6,0,0,0,0,2504,6,2498,2504,1261,1243,2472,42,003,406000
42,407001,0000048762695,00004680,1944,1944,0,1944,1860,84,4680,4680,0,0,4680,4664,4634,8,7,5,0,10,16,15,1,0,0,0,4680,23,4657,4680,2288,2392,4634,42,003,407001
42,407002,0000026289545,00006883,2640,2640,0,2640,2518,122,6883,6883,0,0,6883,6859,6806,26,6,20,0,1,24,19,5,0,0,0,6883,26,6857,6883,3354,3529,6806,42,003,407002
42,408001,0000026047748,00004325,1688,1688,0,1688,1594,94,4325,4325,0,0,4325,4303,4251,20,5,18,0,9,22,22,0,0,0,0,4325,46,4279,4325,2037,2288,4251,42,003,408001
42,408002,0000011644392,00004906,1820,1820,0,1820,1759,61,4906,4906,0,0,4906,4888,4824,23,2,35,0,4,18,18,0,0,0,0,4906,14,4892,4906,2393,2513,4824,42,003,408002
42,409000,0000043479000,00007683,2500,2500,0,2500,2411,89,7683,7683,0,0,7683,7631,7465,61,5,86,2,12,52,48,4,0,0,0,7683,57,7626,7683,3765,3918,7465,42,003,409000
42,410000,0000002319148,00001149,478,478,0,478,464,14,1149,1149,0,0,1149,1147,1133,0,1,10,0,3,2,2,0,0,0,0,1149,9,1140,1149,568,581,1133,42,003,410000
42,411000,0000040394417,00005996,2018,2018,0,2018,1944,74,5996,5996,0,0,5996,5952,5750,65,0,133,0,4,44,44,0,0,0,0,5996,41,5955,5996,3005,2991,5750,42,003,411000
42,412001,0000022411534,00006501,2341,2341,0,2341,2258,83,6501,6501,0,0,6501,6458,6167,75,2,190,6,18,43,43,0,0,0,0,6501,40,6461,6501,3213,3288,6167,42,003,412001
42,412002,0000012772284,00004863,1632,1632,0,1632,1608,24,4863,4863,0,0,4863,4833,4634,41,3,138,16,1,30,26,4,0,0,0,4863,21,4842,4863,2403,2460,4634,42,003,412002
42,413100,0000015933687,00006773,2656,2656,0,2656,2535,121,6773,6773,0,0,6773,6722,6253,129,2,329,1,8,51,49,2,0,0,0,6773,64,6709,6773,3283,3490,6253,42,003,413100
42,413201,0000003769596,00003850,1625,1625,0,1625,1582,43,3850,3850,0,0,3850,3819,3680,33,4,94,0,8,31,27,4,0,0,0,3850,36,3814,3850,1862,1988,3680,42,003,413201
42,413202,0000004061362,00002715,1143,1143,0,1143,1111,32,2715,2715,0,0,2715,2692,2635,13,0,40,0,4,23,21,2,0,0,0,2715,17,2698,2715,1284,1431,2635,42,003,413202
42,413300,0000005809620,00005116,1875,1875,0,1875,1807,68,5116,5116,0,0,5116,5103,4991,19,6,82,0,5,13,13,0,0,0,0,5116,25,5091,5116,2437,2679,4991,42,003,413300
42,413400,0000004498283,00004584,1663,1663,0,1663,1638,25,4584,4584,0,0,4584,4556,4349,44,0,160,0,3,28,27,1,0,0,0,4584,17,4567,4584,2176,2408,4349,42,003,413400
42,413500,0000008773154,00005984,2735,2735,0,2735,2486,249,5984,5984,0,0,5984,5916,5541,137,3,221,1,13,68,66,0,0,0,2,5984,43,5941,5984,2761,3223,5541,42,003,413500
42,414101,0000009645474,00005612,1943,1943,0,1943,1892,51,5612,5612,0,0,5612,5606,5502,33,0,65,1,5,6,6,0,0,0,0,5612,25,5587,5612,2724,2888,5502,42,003,414101
42,414102,0000018035230,00005971,2498,2498,0,2498,2248,250,5971,5971,0,0,5971,5953,5783,57,8,93,0,12,18,18,0,0,0,0,5971,33,5938,5971,2933,3038,5783,42,003,414102
42,414200,0000013857286,00005943,2186,2186,0,2186,2113,73,5943,5943,0,0,5943,5920,5831,28,0,57,0,4,23,22,1,0,0,0,5943,35,5908,5943,2913,3030,5831,42,003,414200
42,415001,0000032884456,00004042,1499,1499,0,1499,1421,78,4042,4042,0,0,4042,4027,3927,53,4,35,2,6,15,15,0,0,0,0,4042,22,4020,4042,1984,2058,3927,42,003,415001
42,415002,0000013014818,00002767,958,958,0,958,926,32,2767,2767,0,0,2767,2749,2587,35,0,112,0,15,18,16,2,0,0,0,2767,15,2752,2767,1364,1403,2587,42,003,415002
42,416000,0000005798772,00001802,838,838,0,838,797,41,1802,1802,0,0,1802,1796,1795,1,0,0,0,0,6,6,0,0,0,0,1802,2,1800,1802,868,934,1795,42,003,416000
42,417100,0000001093987,00002400,1079,1079,0,1079,1020,59,2400,2400,0,0,2400,2394,2382,2,2,4,0,4,6,6,0,0,0,0,2400,4,2396,2400,1118,1282,2382,42,003,417100
42,417200,0000001321709,00001428,723,723,0,723,665,58,1428,1428,0,0,1428,1423,1409,9,1,1,0,3,5,5,0,0,0,0,1428,4,1424,1428,685,743,1409,42,003,417200
42,418000,0000001241232,00001899,887,887,0,887,853,34,1899,1899,0,0,1899,1899,1889,5,1,4,0,0,0,0,0,0,0,0,1899,9,1890,1899,867,1032,1889,42,003,418000
42,419000,0000015455110,00003242,1637,1637,0,1637,1522,115,3242,3242,0,0,3242,3228,3169,22,3,32,0,2,14,14,0,0,0,0,3242,18,3224,3242,1535,1707,3169,42,003,419000
42,420000,0000000841335,00001550,931,931,0,931,858,73,1550,1550,0,0,1550,1543,1442,16,1,81,0,3,7,7,0,0,0,0,1550,10,1540,1550,720,830,1442,42,003,420000
42,421100,0000008762384,00004197,1613,1613,0,1613,1553,60,4197,4197,0,0,4197,4174,3956,54,3,153,0,8,23,23,0,0,0,0,4197,28,4169,4197,2138,2059,3956,42,003,421100
42,421200,0000009454467,00004659,1768,1768,0,1768,1695,73,4659,4659,0,0,4659,4631,4479,20,1,116,0,15,28,27,1,0,0,0,4659,73,4586,4659,2269,2390,4479,42,003,421200
42,422000,0000020288843,00005436,1942,1942,0,1942,1875,67,5436,5436,0,0,5436,5395,5071,30,1,284,2,7,41,39,2,0,0,0,5436,37,5399,5436,2698,2738,5071,42,003,422000
42,423000,0000000860920,00002960,1584,1584,0,1584,1499,85,2960,2960,0,0,2960,2945,2904,8,1,27,0,5,15,15,0,0,0,0,2960,30,2930,2960,1283,1677,2904,42,003,423000
42,424000,0000001258956,00003594,1911,1911,0,1911,1748,163,3594,3594,0,0,3594,3545,3369,137,1,23,2,13,49,39,7,0,3,0,3594,76,3518,3594,1619,1975,3369,42,003,424000
42,425000,0000001934076,00003924,1934,1934,0,1934,1749,185,3924,3924,0,0,3924,3893,3837,30,14,6,0,6,31,31,0,0,0,0,3924,45,3879,3924,1849,2075,3837,42,003,425000
42,426300,0000005280924,00006194,2467,2467,0,2467,2420,47,6194,6194,0,0,6194,6174,6121,23,3,23,2,2,20,15,5,0,0,0,6194,23,6171,6194,2993,3201,6121,42,003,426300
42,426400,0000003515805,00004819,2141,2141,0,2141,2064,77,4819,4819,0,0,4819,4799,4739,30,5,17,0,8,20,19,1,0,0,0,4819,26,4793,4819,2221,2598,4739,42,003,426400
42,426700,0000003652203,00002664,1260,1260,0,1260,1179,81,2664,2664,0,0,2664,2620,2484,16,1,115,0,4,44,42,2,0,0,0,2664,21,2643,2664,1274,1390,2484,42,003,426700
42,426800,0000005219461,00005295,1942,1942,0,1942,1905,37,5295,5295,0,0,5295,5264,5210,11,1,39,1,2,31,31,0,0,0,0,5295,28,5267,5295,2615,2680,5210,42,003,426800
42,427000,0000001686168,00004028,2085,2085,0,2085,1839,246,4028,4028,0,0,4028,3988,3907,39,8,7,0,27,40,33,7,0,0,0,4028,36,3992,4028,1969,2059,3907,42,003,427000
42,427100,0000006156053,00005605,2161,2161,0,2161,2120,41,5605,5605,0,0,5605,5582,5498,17,1,50,4,12,23,23,0,0,0,0,5605,34,5571,5605,2699,2906,5498,42,003,427100
42,427200,0000004682393,00005180,2363,2363,0,2363,2244,119,5180,5180,0,0,5180,5150,5087,25,7,24,0,7,30,25,5,0,0,0,5180,23,5157,5180,2391,2789,5087,42,003,427200
42,428100,0000000874863,00001424,602,602,0,602,576,26,1424,1424,0,0,1424,1421,1401,11,7,1,0,1,3,3,0,0,0,0,1424,2,1422,1424,697,727,1401,42,003,428100
42,428200,0000004288310,00002432,1003,1003,0,1003,971,32,2432,2432,0,0,2432,2430,2374,41,0,10,0,5,2,2,0,0,0,0,2432,15,2417,2432,1168,1264,2374,42,003,428200
42,429100,0000005796580,00002814,1158,1158,0,1158,1131,27,2814,2814,0,0,2814,2800,2699,54,2,36,0,9,14,13,1,0,0,0,2814,17,2797,2814,1283,1531,2699,42,003,429100
42,429201,0000004682453,00004463,1742,1742,0,1742,1651,91,4463,4463,0,0,4463,4444,4157,68,3,206,3,7,19,19,0,0,0,0,4463,42,4421,4463,2110,2353,4157,42,003,429201
42,429202,0000004363952,00004674,1976,1976,0,1976,1929,47,4674,4674,0,0,4674,4636,4483,42,4,94,0,13,38,34,4,0,0,0,4674,37,4637,4674,2235,2439,4483,42,003,429202
42,429300,0000008393878,00005889,2560,2560,0,2560,2495,65,5889,5889,0,0,5889,5875,5788,33,5,41,5,3,14,14,0,0,0,0,5889,34,5855,5889,2722,3167,5788,42,003,429300
42,429400,0000003540257,00004618,1984,1984,0,1984,1920,64,4618,4618,0,0,4618,4597,4544,25,1,14,4,9,21,19,1,0,1,0,4618,19,4599,4618,2170,2448,4544,42,003,429400
42,429500,0000004109168,00004274,2418,2418,0,2418,2297,121,4274,4274,0,0,4274,4244,3989,87,5,151,4,8,30,27,2,1,0,0,4274,41,4233,4274,1948,2326,3989,42,003,429500
42,429600,0000003388980,00003397,1539,1539,0,1539,1467,72,3397,3397,0,0,3397,3373,3185,137,7,27,5,12,24,18,6,0,0,0,3397,37,3360,3397,1563,1834,3185,42,003,429600
42,429700,0000003106085,00002422,1045,1045,0,1045,1002,43,2422,2422,0,0,2422,2418,2380,17,0,17,0,4,4,4,0,0,0,0,2422,10,2412,2422,1138,1284,2380,42,003,429700
42,430100,0000000856511,00002345,1057,1057,0,1057,995,62,2345,2345,0,0,2345,2327,2283,29,0,12,0,3,18,18,0,0,0,0,2345,10,2335,2345,1116,1229,2283,42,003,430100
42,430200,0000001757270,00004932,2247,2247,0,2247,2154,93,4932,4932,0,0,4932,4901,4821,39,5,26,0,10,31,27,4,0,0,0,4932,29,4903,4932,2296,2636,4821,42,003,430200
42,431100,0000000934380,00003555,1889,1889,0,1889,1725,164,3555,3555,0,0,3555,3496,3290,172,6,21,0,7,59,56,2,1,0,0,3555,33,3522,3555,1594,1961,3290,42,003,431100
42,431400,0000000680137,00001822,958,958,0,958,900,58,1822,1822,0,0,1822,1803,1729,62,5,6,0,1,19,18,1,0,0,0,1822,10,1812,1822,797,1025,1729,42,003,431400
42,431500,0000000976036,00003393,1923,1923,0,1923,1764,159,3393,3393,0,0,3393,3361,3169,152,4,30,0,6,32,28,4,0,0,0,3393,28,3365,3393,1525,1868,3169,42,003,431500
42,432300,0000000902126,00002317,1327,1327,0,1327,1232,95,2317,2317,0,0,2317,2287,2153,122,2,8,0,2,30,29,1,0,0,0,2317,15,2302,2317,1028,1289,2153,42,003,432300
42,432400,0000000728407,00002977,1518,1518,0,1518,1397,121,2977,2977,0,0,2977,2933,2772,135,3,16,1,6,44,38,6,0,0,0,2977,16,2961,2977,1398,1579,2772,42,003,432400
42,433000,0000000435961,00000392,144,144,0,144,138,6,392,392,0,0,392,389,387,1,0,1,0,0,3,3,0,0,0,0,392,3,389,392,203,189,387,42,003,433000
42,434000,0000001033269,00001917,825,825,0,825,784,41,1917,1917,0,0,1917,1899,1839,47,7,5,0,1,18,17,1,0,0,0,1917,9,1908,1917,893,1024,1839,42,003,434000
42,435000,0000001488979,00002598,1228,1228,0,1228,1153,75,2598,2598,0,0,2598,2578,2453,93,1,30,0,1,20,20,0,0,0,0,2598,11,2587,2598,1309,1289,2453,42,003,435000
42,436000,0000006589633,00000723,318,318,0,318,310,8,723,723,0,0,723,720,715,4,0,1,0,0,3,2,1,0,0,0,723,1,722,723,370,353,715,42,003,436000
42,437000,0000017764557,00003086,1177,1177,0,1177,1106,71,3086,3086,0,0,3086,3071,2992,26,2,46,2,3,15,14,1,0,0,0,3086,14,3072,3086,1543,1543,2992,42,003,437000
42,438000,0000006449565,00000652,231,231,0,231,225,6,652,652,0,0,652,648,615,16,0,12,0,5,4,2,2,0,0,0,652,11,641,652,331,321,615,42,003,438000
42,439000,0000013493570,00001382,540,540,0,540,520,20,1382,1382,0,0,1382,1371,1322,15,9,21,0,4,11,10,1,0,0,0,1382,3,1379,1382,683,699,1322,42,003,439000
42,440000,0000018972275,00000981,355,355,0,355,336,19,981,981,0,0,981,972,955,9,0,6,0,2,9,9,0,0,0,0,981,3,978,981,419,562,955,42,003,440000
42,441000,0000004692271,00001039,509,509,0,509,483,26,1039,1039,0,0,1039,1036,992,32,0,11,0,1,3,3,0,0,0,0,1039,10,1029,1039,494,545,992,42,003,441000
42,442000,0000002193311,00000236,96,96,0,96,90,6,236,236,0,0,236,235,227,6,2,0,0,0,1,1,0,0,0,0,236,1,235,236,113,123,227,42,003,442000
42,443000,0000000519312,00000078,38,38,0,38,36,2,78,78,0,0,78,76,76,0,0,0,0,0,2,2,0,0,0,0,78,0,78,78,38,40,76,42,003,443000
42,444000,0000001160775,00000566,222,222,0,222,216,6,566,566,0,0,566,565,555,9,0,0,0,1,1,1,0,0,0,0,566,2,564,566,269,297,555,42,003,444000
42,445500,0000002482377,00003902,2037,2037,0,2037,1891,146,3902,3902,0,0,3902,3859,3442,376,5,33,1,2,43,38,5,0,0,0,3902,42,3860,3902,1732,2170,3442,42,003,445500
42,446000,0000003952533,00001730,671,671,0,671,644,27,1730,1730,0,0,1730,1716,1658,34,6,16,1,1,14,11,3,0,0,0,1730,15,1715,1730,813,917,1658,42,003,446000
42,447000,0000004127429,00001568,599,599,0,599,569,30,1568,1568,0,0,1568,1549,1487,42,0,15,0,5,19,15,1,0,3,0,1568,12,1556,1568,752,816,1487,42,003,447000
42,448000,0000002560816,00001232,653,653,0,653,576,77,1232,1232,0,0,1232,1197,1099,90,0,0,0,8,35,30,5,0,0,0,1232,20,1212,1232,549,683,1099,42,003,448000
42,449000,0000005371094,00002314,920,920,0,920,886,34,2314,2314,0,0,2314,2308,2250,29,7,21,1,0,6,6,0,0,0,0,2314,18,2296,2314,1119,1195,2250,42,003,449000
42,450700,0000002062539,00003402,1670,1670,0,1670,1562,108,3402,3402,0,0,3402,3354,3127,206,3,10,0,8,48,45,3,0,0,0,3402,25,3377,3402,1549,1853,3127,42,003,450700
42,450800,0000001402807,00002729,1449,1449,0,1449,1318,131,2729,2729,0,0,2729,2675,2082,556,2,7,1,27,54,48,6,0,0,0,2729,35,2694,2729,1251,1478,2082,42,003,450800
42,451101,0000007381645,00003591,1458,1458,0,1458,1402,56,3591,3591,0,0,3591,3570,3441,68,0,51,0,10,21,18,3,0,0,0,3591,39,3552,3591,1725,1866,3441,42,003,451101
42,451102,0000005940863,00005573,2190,2190,0,2190,2029,161,5573,5573,0,0,5573,5480,4913,420,9,119,4,15,93,74,19,0,0,0,5573,56,5517,5573,2835,2738,4913,42,003,451102
42,451103,0000017152698,00007178,3247,3247,0,3247,2785,462,7178,7178,0,0,7178,7126,6707,203,5,194,1,16,52,51,1,0,0,0,7178,66,7112,7178,3544,3634,6707,42,003,451103
42,451300,0000031002648,00005948,2305,2305,0,2305,2229,76,5948,5948,0,0,5948,5898,5707,107,0,69,0,15,50,49,1,0,0,0,5948,59,5889,5948,2890,3058,5707,42,003,451300
42,452000,0000084409025,00005145,2128,2128,0,2128,2028,100,5145,5145,0,0,5145,5100,4948,84,7,57,0,4,45,42,3,0,0,0,5145,29,5116,5145,2525,2620,4948,42,003,452000
42,453001,0000022858995,00008416,3697,3697,0,3697,3494,203,8416,8416,0,0,8416,8365,7786,250,13,301,0,15,51,42,9,0,0,0,8416,88,8328,8416,4127,4289,7786,42,003,453001
42,453002,0000042101277,00003838,1596,1596,0,1596,1510,86,3838,3838,0,0,3838,3815,3732,69,2,6,1,5,23,19,4,0,0,0,3838,20,3818,3838,1895,1943,3732,42,003,453002
42,454000,0000000528241,00000415,180,180,0,180,171,9,415,415,0,0,415,412,389,22,0,1,0,0,3,3,0,0,0,0,415,0,415,415,197,218,389,42,003,454000
42,455000,0000001358948,00001551,640,640,0,640,604,36,1551,1551,0,0,1551,1545,1523,14,1,1,0,6,6,6,0,0,0,0,1551,11,1540,1551,748,803,1523,42,003,455000
42,456001,0000014416713,00003082,1175,1175,0,1175,1121,54,3082,3082,0,0,3082,3072,2996,36,1,36,1,2,10,10,0,0,0,0,3082,14,3068,3082,1526,1556,2996,42,003,456001
42,456003,0000031582650,00004169,1806,1806,0,1806,1728,78,4169,4169,0,0,4169,4148,3990,95,1,45,0,17,21,21,0,0,0,0,4169,25,4144,4169,1964,2205,3990,42,003,456003
42,456004,0000006686797,00005020,1943,1943,0,1943,1855,88,5020,5020,0,0,5020,4975,4540,298,0,114,5,18,45,40,3,2,0,0,5020,49,4971,5020,2334,2686,4540,42,003,456004
42,457100,0000000937947,00001580,828,828,0,828,792,36,1580,1580,0,0,1580,1573,1498,60,0,5,0,10,7,5,2,0,0,0,1580,15,1565,1580,728,852,1498,42,003,457100
42,457200,0000001863123,00003761,1828,1828,0,1828,1747,81,3761,3761,0,0,3761,3729,3525,176,5,15,0,8,32,25,7,0,0,0,3761,26,3735,3761,1756,2005,3525,42,003,457200
42,458000,0000036753732,00005265,2358,2358,0,2358,2224,134,5265,5265,0,0,5265,5239,5163,39,0,26,0,11,26,21,4,1,0,0,5265,19,5246,5265,2520,2745,5163,42,003,458000
42,459101,0000006016422,00001779,731,731,0,731,685,46,1779,1779,0,0,1779,1765,1672,79,1,11,0,2,14,14,0,0,0,0,1779,10,1769,1779,893,886,1672,42,003,459101
42,459102,0000009461939,00005096,1733,1733,0,1733,1699,34,5096,5096,0,0,5096,5069,4961,52,2,53,0,1,27,27,0,0,0,0,5096,32,5064,5096,2499,2597,4961,42,003,459102
42,459201,0000022722143,00005414,2694,2694,0,2694,2444,250,5414,5414,0,0,5414,5383,5072,103,4,187,3,14,31,30,1,0,0,0,5414,48,5366,5414,2652,2762,5072,42,003,459201
42,459202,0000000150383,00000738,500,500,0,500,491,9,738,738,0,0,738,733,708,12,6,6,0,1,5,5,0,0,0,0,738,6,732,738,299,439,708,42,003,459202
42,460001,0000006779100,00004176,1776,1776,0,1776,1739,37,4176,4176,0,0,4176,4168,4134,13,0,18,2,1,8,8,0,0,0,0,4176,16,4160,4176,1934,2242,4134,42,003,460001
42,460002,0000007322052,00003328,1204,1204,0,1204,1178,26,3328,3328,0,0,3328,3314,3268,25,1,18,0,2,14,12,2,0,0,0,3328,6,3322,3328,1650,1678,3268,42,003,460002
42,461000,0000003433213,00001232,676,676,0,676,624,52,1232,1232,0,0,1232,1219,1199,15,1,0,0,4,13,11,2,0,0,0,1232,11,1221,1232,600,632,1199,42,003,461000
42,462100,0000004059617,00002637,1444,1444,0,1444,1196,248,2637,2637,0,0,2637,2612,2291,308,2,8,0,3,25,24,1,0,0,0,2637,17,2620,2637,1243,1394,2291,42,003,462100
42,462600,0000001061745,00004069,2112,2112,0,2112,1865,247,4069,4069,0,0,4069,4032,3774,231,12,3,0,12,37,37,0,0,0,0,4069,11,4058,4069,1895,2174,3774,42,003,462600
42,463900,0000000989907,00002892,1451,1451,0,1451,1276,175,2892,2892,0,0,2892,2862,2678,162,1,16,0,5,30,30,0,0,0,0,2892,33,2859,2892,1361,1531,2678,42,003,463900
42,464300,0000001127732,00003712,1650,1650,0,1650,1565,85,3712,3712,0,0,3712,3692,3542,114,8,20,0,8,20,20,0,0,0,0,3712,21,3691,3712,1740,1972,3542,42,003,464300
42,464400,0000001699390,00003730,1951,1951,0,1951,1629,322,3730,3730,0,0,3730,3637,2799,769,16,29,2,22,93,86,7,0,0,0,3730,39,3691,3730,1759,1971,2799,42,003,464400
42,465600,0000000967980,00002826,1540,1540,0,1540,1382,158,2826,2826,0,0,2826,2793,2642,109,6,28,4,4,33,26,7,0,0,0,2826,9,2817,2826,1321,1505,2642,42,003,465600
42,465800,0000001967863,00003880,1804,1804,0,1804,1697,107,3880,3880,0,0,3880,3857,3762,75,1,12,1,6,23,20,3,0,0,0,3880,29,3851,3880,1858,2022,3762,42,003,465800
42,466000,0000001142616,00000468,182,182,0,182,177,5,468,468,0,0,468,458,453,0,0,4,0,1,10,10,0,0,0,0,468,7,461,468,228,240,453,42,003,466000
42,467000,0000001565526,00000464,193,193,0,193,185,8,464,464,0,0,464,463,460,3,0,0,0,0,1,1,0,0,0,0,464,2,462,464,231,233,460,42,003,467000
42,468700,0000001420691,00001984,906,906,0,906,853,53,1984,1984,0,0,1984,1972,1894,66,0,9,0,3,12,12,0,0,0,0,1984,5,1979,1984,926,1058,1894,42,003,468700
42,468800,0000001107988,00002365,1220,1220,0,1220,1127,93,2365,2365,0,0,2365,2349,2208,99,5,22,0,15,16,14,2,0,0,0,2365,24,2341,2365,1122,1243,2208,42,003,468800
42,468900,0000001751123,00004040,2123,2123,0,2123,1987,136,4040,4040,0,0,4040,3954,3559,302,2,72,4,15,86,76,10,0,0,0,4040,54,3986,4040,1807,2233,3559,42,003,468900
42,469000,0000005437629,00004719,2026,2026,0,2026,1974,52,4719,4719,0,0,4719,4659,4540,25,0,92,0,2,60,60,0,0,0,0,4719,31,4688,4719,2251,2468,4540,42,003,469000
42,470300,0000003527702,00003805,1583,1583,0,1583,1539,44,3805,3805,0,0,3805,3794,3672,42,1,74,0,5,11,10,1,0,0,0,3805,27,3778,3805,1698,2107,3672,42,003,470300
42,470400,0000001820866,00003461,1456,1456,0,1456,1424,32,3461,3461,0,0,3461,3443,3392,15,2,29,2,3,18,18,0,0,0,0,3461,15,3446,3461,1584,1877,3392,42,003,470400
42,470500,0000003001216,00006643,3421,3421,0,3421,3276,145,6643,6643,0,0,6643,6527,5465,95,10,935,0,22,116,115,1,0,0,0,6643,48,6595,6643,3218,3425,5465,42,003,470500
42,470600,0000001941671,00003379,1703,1703,0,1703,1596,107,3379,3379,0,0,3379,3349,3263,46,1,29,0,10,30,29,1,0,0,0,3379,27,3352,3379,1636,1743,3263,42,003,470600
42,471000,0000000681671,00001225,606,606,0,606,571,35,1225,1225,0,0,1225,1214,1196,12,0,3,0,3,11,11,0,0,0,0,1225,7,1218,1225,571,654,1196,42,003,471000
42,472100,0000000530825,00002755,1313,1313,0,1313,1241,72,2755,2755,0,0,2755,2718,2599,42,7,60,1,9,37,32,5,0,0,0,2755,36,2719,2755,1272,1483,2599,42,003,472100
42,472200,0000000640793,00002390,1112,1112,0,1112,1065,47,2390,2390,0,0,2390,2379,2331,22,3,18,4,1,11,6,5,0,0,0,2390,20,2370,2390,1141,1249,2331,42,003,472200
42,472300,0000000338346,00002203,1059,1059,0,1059,998,61,2203,2203,0,0,2203,2190,2099,32,3,49,0,7,13,13,0,0,0,0,2203,29,2174,2203,1033,1170,2099,42,003,472300
42,472400,0000000408306,00001957,803,803,0,803,785,18,1957,1957,0,0,1957,1942,1911,2,3,25,0,1,15,15,0,0,0,0,1957,14,1943,1957,945,1012,1911,42,003,472400
42,473100,0000001540194,00004964,2389,2389,0,2389,2267,122,4964,4964,0,0,4964,4924,4770,37,7,90,0,20,40,40,0,0,0,0,4964,41,4923,4964,2323,2641,4770,42,003,473100
42,473200,0000000742886,00003432,1832,1832,0,1832,1752,80,3432,3432,0,0,3432,3409,3255,26,7,113,0,8,23,23,0,0,0,0,3432,34,3398,3432,1523,1909,3255,42,003,473200
42,473300,0000003315634,00005477,2153,2153,0,2153,2101,52,5477,5477,0,0,5477,5434,5353,26,2,46,0,7,43,40,3,0,0,0,5477,36,5441,5477,2550,2927,5353,42,003,473300
42,473401,0000001501460,00003768,1663,1663,0,1663,1606,57,3768,3768,0,0,3768,3743,3593,19,0,121,1,9,25,22,3,0,0,0,3768,35,3733,3768,1803,1965,3593,42,003,473401
42,473402,0000001682982,00003681,1481,1481,0,1481,1434,47,3681,3681,0,0,3681,3658,3523,22,0,105,1,7,23,23,0,0,0,0,3681,37,3644,3681,1756,1925,3523,42,003,473402
42,473500,0000002354216,00003619,1319,1319,0,1319,1288,31,3619,3619,0,0,3619,3597,3517,24,3,50,1,2,22,20,2,0,0,0,3619,43,3576,3619,1678,1941,3517,42,003,473500
42,473601,0000002127728,00003839,1363,1363,0,1363,1333,30,3839,3839,0,0,3839,3826,3691,34,1,97,1,2,13,13,0,0,0,0,3839,26,3813,3839,1749,2090,3691,42,003,473601
42,473602,0000002404653,00004237,1889,1889,0,1889,1829,60,4237,4237,0,0,4237,4222,4064,14,3,135,0,6,15,15,0,0,0,0,4237,11,4226,4237,1988,2249,4064,42,003,473602
42,474101,0000004002305,00003800,1403,1403,0,1403,1371,32,3800,3800,0,0,3800,3760,3565,44,1,148,0,2,40,40,0,0,0,0,3800,30,3770,3800,1837,1963,3565,42,003,474101
42,474102,0000004653091,00003502,1281,1281,0,1281,1248,33,3502,3502,0,0,3502,3487,3350,15,2,120,0,0,15,15,0,0,0,0,3502,36,3466,3502,1710,1792,3350,42,003,474102
42,474201,0000003239086,00002630,907,907,0,907,897,10,2630,2630,0,0,2630,2621,2508,21,0,88,0,4,9,9,0,0,0,0,2630,15,2615,2630,1284,1346,2508,42,003,474201
42,474202,0000008885853,00005368,1881,1881,0,1881,1853,28,5368,5368,0,0,5368,5334,5100,32,1,191,4,6,34,31,3,0,0,0,5368,46,5322,5368,2494,2874,5100,42,003,474202
42,474203,0000004484600,00004753,1619,1619,0,1619,1597,22,4753,4753,0,0,4753,4727,4439,24,1,259,1,3,26,26,0,0,0,0,4753,30,4723,4753,2376,2377,4439,42,003,474203
42,475101,0000003139162,00005037,2541,2541,0,2541,2400,141,5037,5037,0,0,5037,4988,4796,77,2,106,4,3,49,42,7,0,0,0,5037,18,5019,5037,2218,2819,4796,42,003,475101
42,475102,0000001790795,00001909,704,704,0,704,695,9,1909,1909,0,0,1909,1892,1844,33,0,13,0,2,17,15,2,0,0,0,1909,7,1902,1909,952,957,1844,42,003,475102
42,475200,0000004770163,00005080,2026,2026,0,2026,1971,55,5080,5080,0,0,5080,5055,4985,26,2,35,1,6,25,24,1,0,0,0,5080,28,5052,5080,2478,2602,4985,42,003,475200
42,475301,0000003425761,00004590,2166,2166,0,2166,2032,134,4590,4590,0,0,4590,4561,4427,98,1,26,2,7,29,28,1,0,0,0,4590,24,4566,4590,2152,2438,4427,42,003,475301
42,475303,0000003098361,00004291,1552,1552,0,1552,1520,32,4291,4291,0,0,4291,4284,4214,20,0,43,2,5,7,7,0,0,0,0,4291,17,4274,4291,2090,2201,4214,42,003,475303
42,475304,0000004350244,00005828,2201,2201,0,2201,2131,70,5828,5828,0,0,5828,5792,5606,56,4,114,0,12,36,32,4,0,0,0,5828,39,5789,5828,2834,2994,5606,42,003,475304
42,475401,0000005867012,00003719,1510,1510,0,1510,1483,27,3719,3719,0,0,3719,3714,3675,20,1,9,0,9,5,4,1,0,0,0,3719,21,3698,3719,1786,1933,3675,42,003,475401
42,475402,0000003842956,00003102,1171,1171,0,1171,1130,41,3102,3102,0,0,3102,3076,3037,13,0,25,0,1,26,23,3,0,0,0,3102,10,3092,3102,1559,1543,3037,42,003,475402
42,476100,0000002478624,00005083,2525,2525,0,2525,2403,122,5083,5083,0,0,5083,5055,4878,87,2,63,1,24,28,27,1,0,0,0,5083,60,5023,5083,2384,2699,4878,42,003,476100
42,476200,0000001734415,00003473,1512,1512,0,1512,1456,56,3473,3473,0,0,3473,3458,3414,28,3,4,0,9,15,15,0,0,0,0,3473,24,3449,3473,1670,1803,3414,42,003,476200
42,477100,0000002119053,00003694,1554,1554,0,1554,1516,38,3694,3694,0,0,3694,3690,3678,4,0,8,0,0,4,4,0,0,0,0,3694,12,3682,3694,1675,2019,3678,42,003,477100
42,477200,0000002889061,00004456,2066,2066,0,2066,2012,54,4456,4456,0,0,4456,4444,4408,14,0,12,0,10,12,9,2,1,0,0,4456,28,4428,4456,1985,2471,4408,42,003,477200
42,477300,0000003498376,00006294,2899,2899,0,2899,2766,133,6294,6294,0,0,6294,6203,5867,187,3,114,2,30,91,89,2,0,0,0,6294,56,6238,6294,3048,3246,5867,42,003,477300
42,478100,0000001521400,00004407,2204,2204,0,2204,2086,118,4407,4407,0,0,4407,4386,4299,36,7,32,0,12,21,20,1,0,0,0,4407,24,4383,4407,2083,2324,4299,42,003,478100
42,478200,0000002224065,00006059,2691,2691,0,2691,2572,119,6059,6059,0,0,6059,6026,5952,20,18,25,1,10,33,31,2,0,0,0,6059,48,6011,6059,2895,3164,5952,42,003,478200
42,479000,0000001400826,00002244,880,880,0,880,869,11,2244,2244,0,0,2244,2235,2213,6,0,13,0,3,9,7,2,0,0,0,2244,9,2235,2244,1055,1189,2213,42,003,479000
42,480101,0000002286676,00004562,2338,2338,0,2338,1841,497,4562,4562,0,0,4562,4492,4098,319,4,44,0,27,70,69,1,0,0,0,4562,61,4501,4562,2094,2468,4098,42,003,480101
42,480102,0000001646466,00003297,1368,1368,0,1368,1339,29,3297,3297,0,0,3297,3289,3173,80,1,31,1,3,8,6,2,0,0,0,3297,6,3291,3297,1567,1730,3173,42,003,480102
42,480200,0000003075267,00003498,1465,1465,0,1465,1414,51,3498,3498,0,0,3498,3486,3448,17,2,18,0,1,12,9,3,0,0,0,3498,22,3476,3498,1687,1811,3448,42,003,480200
42,480300,0000002919220,00003321,1430,1430,0,1430,1382,48,3321,3321,0,0,3321,3315,3293,9,0,13,0,0,6,6,0,0,0,0,3321,13,3308,3321,1596,1725,3293,42,003,480300
42,480400,0000005018849,00005321,2282,2282,0,2282,2217,65,5321,5321,0,0,5321,5296,5227,58,2,6,0,3,25,21,4,0,0,0,5321,27,5294,5321,2534,2787,5227,42,003,480400
42,481000,0000000877326,00003970,1864,1864,0,1864,1681,183,3970,3970,0,0,3970,3893,3325,466,9,65,1,27,77,74,3,0,0,0,3970,43,3927,3970,1895,2075,3325,42,003,481000
42,482500,0000002362162,00002197,1106,1106,0,1106,956,150,2197,2197,0,0,2197,2178,1967,194,4,12,0,1,19,18,1,0,0,0,2197,12,2185,2197,1032,1165,1967,42,003,482500
42,483800,0000001471555,00003569,2071,2071,0,2071,1607,464,3569,3569,0,0,3569,3472,1522,1831,9,101,1,8,97,94,3,0,0,0,3569,22,3547,3569,1587,1982,1522,42,003,483800
42,484300,0000002164691,00003475,1735,1735,0,1735,1538,197,3475,3475,0,0,3475,3426,3039,332,1,39,0,15,49,43,6,0,0,0,3475,33,3442,3475,1652,1823,3039,42,003,484300
42,484500,0000002546294,00006263,2920,2920,0,2920,2769,151,6263,6263,0,0,6263,6240,6185,16,0,24,0,15,23,19,4,0,0,0,6263,43,6220,6263,2877,3386,6185,42,003,484500
42,484600,0000001269481,00002526,1125,1125,0,1125,1057,68,2526,2526,0,0,2526,2485,2400,67,1,12,0,5,41,29,10,2,0,0,2526,22,2504,2526,1105,1421,2400,42,003,484600
42,485000,0000000782793,00001338,620,620,0,620,560,60,1338,1338,0,0,1338,1328,1253,67,0,0,0,8,10,9,1,0,0,0,1338,7,1331,1338,673,665,1253,42,003,485000
42,486700,0000002493404,00002835,1504,1504,0,1504,1294,210,2835,2835,0,0,2835,2755,1503,1232,1,0,1,18,80,68,12,0,0,0,2835,34,2801,2835,1228,1607,1503,42,003,486700
42,486800,0000001278258,00002174,1112,1112,0,1112,920,192,2174,2174,0,0,2174,2141,1174,950,0,7,0,10,33,31,2,0,0,0,2174,11,2163,2174,968,1206,1174,42,003,486800
42,486900,0000000934557,00002323,1152,1152,0,1152,965,187,2323,2323,0,0,2323,2268,910,1319,10,3,0,26,55,54,1,0,0,0,2323,8,2315,2323,1070,1253,910,42,003,486900
42,487000,0000002633436,00002015,1021,1021,0,1021,948,73,2015,2015,0,0,2015,2009,1989,10,5,0,0,5,6,6,0,0,0,0,2015,12,2003,2015,920,1095,1989,42,003,487000
42,488100,0000001669701,00002449,1063,1063,0,1063,1003,60,2449,2449,0,0,2449,2419,2003,398,2,4,3,9,30,22,8,0,0,0,2449,6,2443,2449,1212,1237,2003,42,003,488100
42,488200,0000002921060,00003848,1609,1609,0,1609,1540,69,3848,3848,0,0,3848,3802,2873,906,12,6,0,5,46,37,9,0,0,0,3848,16,3832,3848,1732,2116,2873,42,003,488200
42,488300,0000006204765,00002327,998,998,0,998,957,41,2327,2327,0,0,2327,2320,2299,18,0,2,0,1,7,7,0,0,0,0,2327,13,2314,2327,1116,1211,2299,42,003,488300
42,488400,0000003575609,00004903,2318,2318,0,2318,2227,91,4903,4903,0,0,4903,4864,4612,231,1,7,1,12,39,37,2,0,0,0,4903,16,4887,4903,2214,2689,4612,42,003,488400
42,488500,0000009630247,00003248,1491,1491,0,1491,1427,64,3248,3248,0,0,3248,3233,3147,59,1,15,0,11,15,14,1,0,0,0,3248,27,3221,3248,1617,1631,3147,42,003,488500
42,488600,0000012678928,00005689,2487,2487,0,2487,2355,132,5689,5689,0,0,5689,5638,5203,375,10,22,9,19,51,50,0,1,0,0,5689,49,5640,5689,2710,2979,5203,42,003,488600
42,489001,0000003610232,00004373,1972,1972,0,1972,1879,93,4373,4373,0,0,4373,4359,4242,52,2,52,0,11,14,14,0,0,0,0,4373,19,4354,4373,2029,2344,4242,42,003,489001
42,489002,0000003439895,00004024,1600,1600,0,1600,1543,57,4024,4024,0,0,4024,4007,3907,58,2,38,1,1,17,17,0,0,0,0,4024,11,4013,4024,1991,2033,3907,42,003,489002
42,490002,0000008042512,00005565,2456,2456,0,2456,2345,111,5565,5565,0,0,5565,5525,5150,315,8,40,0,12,40,35,5,0,0,0,5565,36,5529,5565,2732,2833,5150,42,003,490002
42,490003,0000007621618,00003558,1467,1467,0,1467,1407,60,3558,3558,0,0,3558,3541,3484,27,0,26,4,0,17,14,3,0,0,0,3558,14,3544,3558,1755,1803,3484,42,003,490003
42,490004,0000008088654,00005217,1693,1693,0,1693,1670,23,5217,5217,0,0,5217,5180,5011,118,1,43,2,5,37,36,1,0,0,0,5217,29,5188,5217,2545,2672,5011,42,003,490004
42,491101,0000016833822,00005132,2006,2006,0,2006,1914,92,5132,5132,0,0,5132,5104,4929,72,13,81,0,9,28,24,4,0,0,0,5132,48,5084,5132,2463,2669,4929,42,003,491101
42,491102,0000015722650,00002298,955,955,0,955,915,40,2298,2298,0,0,2298,2290,2255,27,2,4,0,2,8,8,0,0,0,0,2298,11,2287,2298,1134,1164,2255,42,003,491102
42,491200,0000010349447,00002236,993,993,0,993,952,41,2236,2236,0,0,2236,2221,2169,28,1,20,0,3,15,15,0,0,0,0,2236,8,2228,2236,1026,1210,2169,42,003,491200
42,492700,0000003887501,00002533,1225,1225,0,1225,1075,150,2533,2533,0,0,2533,2506,2239,252,3,7,0,5,27,24,3,0,0,0,2533,17,2516,2533,1215,1318,2239,42,003,492700
42,492800,0000001627633,00003117,1638,1638,0,1638,1328,310,3117,3117,0,0,3117,3054,1345,1695,3,1,0,10,63,58,3,1,0,1,3117,27,3090,3117,1359,1758,1345,42,003,492800
42,492900,0000001642996,00002841,1487,1487,0,1487,1307,180,2841,2841,0,0,2841,2761,2285,458,3,6,0,9,80,74,5,1,0,0,2841,18,2823,2841,1294,1547,2285,42,003,492900
42,493000,0000000529323,00000565,279,279,0,279,247,32,565,565,0,0,565,564,561,1,0,2,0,0,1,1,0,0,0,0,565,0,565,565,262,303,561,42,003,493000
42,494000,0000000916937,00001609,758,758,0,758,681,77,1609,1609,0,0,1609,1593,1526,58,6,3,0,0,16,16,0,0,0,0,1609,4,1605,1609,726,883,1526,42,003,494000
42,495000,0000049016456,00003771,1616,1616,0,1616,1485,131,3771,3771,0,0,3771,3743,3681,41,5,12,1,3,28,24,4,0,0,0,3771,12,3759,3771,1832,1939,3681,42,003,495000
42,496101,0000011625872,00003257,1222,1222,0,1222,1183,39,3257,3257,0,0,3257,3243,3202,33,0,3,0,5,14,12,2,0,0,0,3257,6,3251,3257,1545,1712,3202,42,003,496101
42,496102,0000032470253,00004582,1930,1930,0,1930,1859,71,4582,4582,0,0,4582,4559,4397,135,1,15,2,9,23,18,0,0,0,5,4582,12,4570,4582,2194,2388,4397,42,003,496102
42,496200,0000014320160,00006000,2526,2526,0,2526,2425,101,6000,6000,0,0,6000,5973,5874,66,5,18,0,10,27,27,0,0,0,0,6000,33,5967,6000,2902,3098,5874,42,003,496200
42,497000,0000012426823,00001218,506,506,0,506,484,22,1218,1218,0,0,1218,1216,1203,8,1,4,0,0,2,2,0,0,0,0,1218,9,1209,1218,584,634,1203,42,003,497000
42,498000,0000003724465,00002670,1162,1162,0,1162,1125,37,2670,2670,0,0,2670,2662,2616,39,3,3,1,0,8,7,1,0,0,0,2670,10,2660,2670,1255,1415,2616,42,003,498000
42,499300,0000002178306,00001729,796,796,0,796,746,50,1729,1729,0,0,1729,1715,1695,10,2,3,3,2,14,10,3,0,1,0,1729,16,1713,1729,823,906,1695,42,003,499300
42,499400,0000002178066,00003264,1609,1609,0,1609,1441,168,3264,3264,0,0,3264,3253,3210,18,12,6,0,7,11,10,1,0,0,0,3264,25,3239,3264,1525,1739,3210,42,003,499400
42,500300,0000002838084,00004228,1940,1940,0,1940,1826,114,4228,4228,0,0,4228,4212,4175,29,1,1,1,5,16,16,0,0,0,0,4228,32,4196,4228,2027,2201,4175,42,003,500300
42,501000,0000001271713,00001724,937,937,0,937,852,85,1724,1724,0,0,1724,1707,1653,44,3,6,0,1,17,16,1,0,0,0,1724,13,1711,1724,768,956,1653,42,003,501000
42,502000,0000002230371,00000351,162,162,0,162,151,11,351,351,0,0,351,351,351,0,0,0,0,0,0,0,0,0,0,0,351,1,350,351,174,177,351,42,003,502000
42,503001,0000011840085,00002007,910,910,0,910,877,33,2007,2007,0,0,2007,1998,1957,35,0,4,0,2,9,9,0,0,0,0,2007,6,2001,2007,973,1034,1957,42,003,503001
42,503002,0000005419117,00006425,2909,2909,0,2909,2799,110,6425,6425,0,0,6425,6397,6239,122,1,26,1,8,28,27,1,0,0,0,6425,28,6397,6425,3014,3411,6239,42,003,503002
42,504100,0000008776817,00005746,2701,2701,0,2701,2541,160,5746,5746,0,0,5746,5627,4641,935,4,28,2,17,119,109,10,0,0,0,5746,34,5712,5746,2624,3122,4641,42,003,504100
42,504400,0000012225467,00005379,2526,2526,0,2526,2392,134,5379,5379,0,0,5379,5348,5128,152,3,57,1,7,31,28,3,0,0,0,5379,20,5359,5379,2626,2753,5128,42,003,504400
42,505000,0000000465786,00000031,10,10,0,10,10,0,31,31,0,0,31,31,31,0,0,0,0,0,0,0,0,0,0,0,31,0,31,31,15,16,31,42,003,505000
42,506000,0000001147420,00000727,363,363,0,363,324,39,727,727,0,0,727,723,707,15,0,1,0,0,4,4,0,0,0,0,727,2,725,727,345,382,707,42,003,506000
42,507000,0000001020241,00002343,1154,1154,0,1154,1078,76,2343,2343,0,0,2343,2318,2241,67,3,3,0,4,25,22,3,0,0,0,2343,16,2327,2343,1121,1222,2241,42,003,507000
42,508000,0000001159901,00002145,1199,1199,0,1199,1032,167,2145,2145,0,0,2145,2110,1959,136,3,5,0,7,35,33,2,0,0,0,2145,27,2118,2145,972,1173,1959,42,003,508000
42,509400,0000002536077,00006076,2969,2969,0,2969,2717,252,6076,6076,0,0,6076,5998,5633,314,5,37,0,9,78,76,2,0,0,0,6076,37,6039,6076,2726,3350,5633,42,003,509400
42,510000,0000001011712,00002017,1107,1107,0,1107,936,171,2017,2017,0,0,2017,1973,1535,422,7,2,1,6,44,40,4,0,0,0,2017,10,2007,2017,888,1129,1535,42,003,510000
42,511000,0000000409792,00000870,449,449,0,449,407,42,870,870,0,0,870,858,813,33,2,6,1,3,12,10,1,1,0,0,870,4,866,870,447,423,813,42,003,511000
42,512000,0000001337143,00002733,1328,1328,0,1328,1171,157,2733,2733,0,0,2733,2704,2378,309,0,4,1,12,29,27,2,0,0,0,2733,25,2708,2733,1320,1413,2378,42,003,512000
42,512800,0000002166168,00001890,1094,1094,0,1094,775,319,1890,1890,0,0,1890,1840,859,952,5,15,1,8,50,47,2,1,0,0,1890,31,1859,1890,887,1003,859,42,003,512800
42,512900,0000000491813,00001787,828,828,0,828,685,143,1787,1787,0,0,1787,1746,718,1002,6,1,1,18,41,37,4,0,0,0,1787,24,1763,1787,817,970,718,42,003,512900
42,513800,0000001461660,00002912,1624,1624,0,1624,1161,463,2912,2912,0,0,2912,2845,877,1937,4,7,0,20,67,53,13,1,0,0,2912,44,2868,2912,1332,1580,877,42,003,513800
42,514000,0000001131391,00002315,1126,1126,0,1126,1002,124,2315,2315,0,0,2315,2269,648,1605,3,4,0,9,46,30,16,0,0,0,2315,8,2307,2315,938,1377,648,42,003,514000
42,515100,0000001114370,00003104,1586,1586,0,1586,1413,173,3104,3104,0,0,3104,3065,1962,1067,6,14,0,16,39,37,2,0,0,0,3104,16,3088,3104,1452,1652,1962,42,003,515100
42,515200,0000000554783,00002245,1246,1246,0,1246,1178,68,2245,2245,0,0,2245,2208,1793,365,0,37,0,13,37,29,8,0,0,0,2245,14,2231,2245,1045,1200,1793,42,003,515200
42,515300,0000000837325,00002026,1103,1103,0,1103,1001,102,2026,2026,0,0,2026,1979,1426,520,4,9,2,18,47,37,8,2,0,0,2026,35,1991,2026,870,1156,1426,42,003,515300
42,515400,0000000387804,00001645,844,844,0,844,782,62,1645,1645,0,0,1645,1611,1400,172,1,23,4,11,34,29,5,0,0,0,1645,28,1617,1645,748,897,1400,42,003,515400
42,515500,0000000210678,00000633,318,318,0,318,305,13,633,633,0,0,633,624,606,13,0,5,0,0,9,9,0,0,0,0,633,9,624,633,304,329,606,42,003,515500
42,516100,0000000713389,00001545,803,803,0,803,776,27,1545,1545,0,0,1545,1532,1432,66,0,22,1,11,13,13,0,0,0,0,1545,24,1521,1545,724,821,1432,42,003,516100
42,516200,0000000817899,00001766,927,927,0,927,863,64,1766,1766,0,0,1766,1752,1519,194,4,27,2,6,14,11,0,3,0,0,1766,21,1745,1766,805,961,1519,42,003,516200
42,517000,0000002511563,00001998,1077,1077,0,1077,1020,57,1998,1998,0,0,1998,1963,1586,359,6,9,0,3,35,34,0,1,0,0,1998,11,1987,1998,890,1108,1586,42,003,517000
42,518001,0000002528863,00003558,1566,1566,0,1566,1492,74,3558,3558,0,0,3558,3536,3395,89,0,49,1,2,22,21,0,1,0,0,3558,29,3529,3558,1661,1897,3395,42,003,518001
42,518002,0000001509220,00003273,1637,1637,0,1637,1558,79,3273,3273,0,0,3273,3246,3076,115,2,42,0,11,27,26,1,0,0,0,3273,20,3253,3273,1518,1755,3076,42,003,518002
42,519000,0000005686107,00003566,1567,1567,0,1567,1519,48,3566,3566,0,0,3566,3541,3156,300,5,69,1,10,25,18,5,2,0,0,3566,41,3525,3566,1719,1847,3156,42,003,519000
42,520001,0000004048621,00003402,1689,1689,0,1689,1593,96,3402,3402,0,0,3402,3368,3126,166,0,68,2,6,34,30,1,3,0,0,3402,16,3386,3402,1620,1782,3126,42,003,520001
42,520002,0000002743593,00003515,1743,1743,0,1743,1642,101,3515,3515,0,0,3515,3481,3292,137,6,37,2,7,34,32,2,0,0,0,3515,15,3500,3515,1646,1869,3292,42,003,520002
42,521100,0000004702318,00004768,1813,1813,0,1813,1765,48,4768,4768,0,0,4768,4673,3652,883,16,92,6,24,95,82,13,0,0,0,4768,49,4719,4768,2301,2467,3652,42,003,521100
42,521200,0000007285883,00004498,2390,2390,0,2390,2167,223,4498,4498,0,0,4498,4440,3788,393,2,238,0,19,58,54,4,0,0,0,4498,42,4456,4498,2120,2378,3788,42,003,521200
42,521301,0000007727926,00004118,2019,2019,0,2019,1864,155,4118,4118,0,0,4118,4048,3527,281,6,217,3,14,70,62,8,0,0,0,4118,40,4078,4118,1749,2369,3527,42,003,521301
42,521302,0000007972078,00004291,2219,2219,0,2219,2005,214,4291,4291,0,0,4291,4258,3608,426,6,195,4,19,33,29,4,0,0,0,4291,44,4247,4291,1989,2302,3608,42,003,521302
42,521401,0000007241083,00002826,1201,1201,0,1201,1140,61,2826,2826,0,0,2826,2805,2607,118,3,74,0,3,21,20,1,0,0,0,2826,19,2807,2826,1365,1461,2607,42,003,521401
42,521402,0000005791121,00004140,1538,1538,0,1538,1521,17,4140,4140,0,0,4140,4090,3565,186,0,333,0,6,50,49,0,1,0,0,4140,11,4129,4140,2059,2081,3565,42,003,521402
42,521500,0000010535160,00004708,1979,1979,0,1979,1914,65,4708,4708,0,0,4708,4673,4371,145,8,145,0,4,35,34,1,0,0,0,4708,20,4688,4708,2199,2509,4371,42,003,521500
42,522000,0000001386271,00003689,1901,1901,0,1901,1675,226,3689,3689,0,0,3689,3656,3619,16,4,15,0,2,33,31,1,0,0,1,3689,20,3669,3689,1757,1932,3619,42,003,522000
42,523100,0000006738441,00005067,2155,2155,0,2155,1980,175,5067,5067,0,0,5067,4971,654,4279,12,3,0,23,96,78,14,4,0,0,5067,33,5034,5067,2341,2726,654,42,003,523100
42,523200,0000003194444,00004423,1903,1903,0,1903,1807,96,4423,4423,0,0,4423,4330,2340,1951,5,14,1,19,93,87,6,0,0,0,4423,33,4390,4423,2016,2407,2340,42,003,523200
42,523300,0000003535857,00004592,1859,1859,0,1859,1793,66,4592,4592,0,0,4592,4556,3734,770,6,29,1,16,36,33,3,0,0,0,4592,29,4563,4592,2067,2525,3734,42,003,523300
42,523400,0000003229658,00005229,2446,2446,0,2446,2367,79,5229,5229,0,0,5229,5165,4329,774,4,39,0,19,64,59,4,1,0,0,5229,36,5193,5229,2410,2819,4329,42,003,523400
42,523501,0000004561503,00005160,2113,2113,0,2113,2044,69,5160,5160,0,0,5160,5078,3615,1382,8,49,0,24,82,69,13,0,0,0,5160,41,5119,5160,2442,2718,3615,42,003,523501
42,523502,0000004641129,00001703,771,771,0,771,720,51,1703,1703,0,0,1703,1684,1465,202,0,9,0,8,19,17,2,0,0,0,1703,11,1692,1703,833,870,1465,42,003,523502
42,523600,0000005308959,00005276,2304,2304,0,2304,2244,60,5276,5276,0,0,5276,5227,4408,740,3,49,3,24,49,49,0,0,0,0,5276,45,5231,5276,2491,2785,4408,42,003,523600
42,523701,0000006397399,00004555,1850,1850,0,1850,1788,62,4555,4555,0,0,4555,4537,4142,371,5,14,0,5,18,15,3,0,0,0,4555,9,4546,4555,2203,2352,4142,42,003,523701
42,523702,0000006860789,00005718,2610,2610,0,2610,2488,122,5718,5718,0,0,5718,5658,4892,704,12,36,0,14,60,55,4,1,0,0,5718,45,5673,5718,2768,2950,4892,42,003,523702
42,523800,0000004811325,00005086,2344,2344,0,2344,2259,85,5086,5086,0,0,5086,5063,4864,174,7,13,0,5,23,19,4,0,0,0,5086,15,5071,5086,2416,2670,4864,42,003,523800
42,524000,0000001385239,00003124,1480,1480,0,1480,1376,104,3124,3124,0,0,3124,3108,2992,96,4,11,0,5,16,15,1,0,0,0,3124,10,3114,3124,1491,1633,2992,42,003,524000
42,525100,0000001409827,00002200,1040,1040,0,1040,992,48,2200,2200,0,0,2200,2191,2163,17,1,9,0,1,9,8,1,0,0,0,2200,19,2181,2200,997,1203,2163,42,003,525100
42,525200,0000001132719,00002213,1232,1232,0,1232,1177,55,2213,2213,0,0,2213,2204,2158,25,0,19,0,2,9,6,0,1,2,0,2213,6,2207,2213,947,1266,2158,42,003,525200
42,525300,0000001669050,00002498,997,997,0,997,949,48,2498,2498,0,0,2498,2482,2441,20,6,6,0,9,16,16,0,0,0,0,2498,18,2480,2498,1111,1387,2441,42,003,525300
42,526101,0000034337551,00006367,2592,2592,0,2592,2472,120,6367,6367,0,0,6367,6339,6133,140,3,52,1,10,28,28,0,0,0,0,6367,25,6342,6367,3053,3314,6133,42,003,526101
42,526102,0000013796965,00002082,815,815,0,815,779,36,2082,2082,0,0,2082,2080,2061,11,0,1,5,2,2,2,0,0,0,0,2082,14,2068,2082,1029,1053,2061,42,003,526102
42,526201,0000006175485,00003668,1427,1427,0,1427,1389,38,3668,3668,0,0,3668,3660,3578,56,0,22,0,4,8,8,0,0,0,0,3668,19,3649,3668,1811,1857,3578,42,003,526201
42,526202,0000011421394,00004955,1974,1974,0,1974,1904,70,4955,4955,0,0,4955,4923,4647,199,6,64,0,7,32,29,2,1,0,0,4955,34,4921,4955,2392,2563,4647,42,003,526202
42,526301,0000004400848,00004323,1600,1600,0,1600,1568,32,4323,4323,0,0,4323,4305,4202,71,5,21,0,6,18,18,0,0,0,0,4323,13,4310,4323,2095,2228,4202,42,003,526301
42,526302,0000004014529,00005545,2216,2216,0,2216,2158,58,5545,5545,0,0,5545,5496,5133,266,9,71,1,16,49,48,1,0,0,0,5545,62,5483,5545,2771,2774,5133,42,003,526302
42,550900,0000000997096,00002630,1198,1198,0,1198,950,248,2630,2630,0,0,2630,2550,1579,934,13,6,0,18,80,73,7,0,0,0,2630,54,2576,2630,1253,1377,1579,42,003,550900
42,551200,0000001322262,00004399,2027,2027,0,2027,1866,161,4399,4399,0,0,4399,4273,2874,1342,16,3,0,38,126,121,4,1,0,0,4399,68,4331,4399,1957,2442,2874,42,003,551200
42,551300,0000003895496,00002783,1213,1213,0,1213,1155,58,2783,2783,0,0,2783,2769,2718,40,5,2,0,4,14,14,0,0,0,0,2783,16,2767,2783,1270,1513,2718,42,003,551300
42,551900,0000001774372,00001789,946,946,0,946,811,135,1789,1789,0,0,1789,1745,1293,435,8,3,0,6,44,44,0,0,0,0,1789,32,1757,1789,860,929,1293,42,003,551900
42,552000,0000000633779,00003051,1349,1349,0,1349,1201,148,3051,3051,0,0,3051,2997,2488,476,8,1,0,24,54,51,3,0,0,0,3051,33,3018,3051,1409,1642,2488,42,003,552000
42,552100,0000000672937,00001589,639,639,0,639,472,167,1589,1589,0,0,1589,1553,609,931,0,4,0,9,36,36,0,0,0,0,1589,19,1570,1589,612,977,609,42,003,552100
42,552200,0000000780707,00001435,693,693,0,693,593,100,1435,1435,0,0,1435,1417,1382,27,1,1,0,6,18,17,1,0,0,0,1435,25,1410,1435,686,749,1382,42,003,552200
42,552300,0000000845706,00003077,1453,1453,0,1453,1151,302,3077,3077,0,0,3077,2950,1382,1524,12,6,2,24,127,112,15,0,0,0,3077,83,2994,3077,1429,1648,1382,42,003,552300
42,552400,0000002039596,00003292,1608,1608,0,1608,1458,150,3292,3292,0,0,3292,3277,3086,172,3,4,0,12,15,14,1,0,0,0,3292,31,3261,3292,1562,1730,3086,42,003,552400
42,560400,0000000528851,00001770,1051,1051,0,1051,857,194,1770,1770,0,0,1770,1722,473,1216,8,14,2,9,48,35,12,1,0,0,1770,23,1747,1770,764,1006,473,42,003,560400
42,560500,0000000468805,00002286,1372,1372,0,1372,1261,111,2286,2286,0,0,2286,2227,1680,500,8,26,0,13,59,54,5,0,0,0,2286,32,2254,2286,1026,1260,1680,42,003,560500
42,560600,0000000377309,00001636,1076,1076,0,1076,749,327,1636,1636,0,0,1636,1597,361,1199,13,17,0,7,39,35,4,0,0,0,1636,13,1623,1636,749,887,361,42,003,560600
42,561000,0000000552064,00001916,1012,1012,0,1012,801,211,1916,1916,0,0,1916,1868,419,1424,14,2,1,8,48,43,5,0,0,0,1916,19,1897,1916,800,1116,419,42,003,561000
42,561100,0000000483100,00001414,691,691,0,691,569,122,1414,1414,0,0,1414,1379,71,1293,5,5,0,5,35,32,3,0,0,0,1414,19,1395,1414,617,797,71,42,003,561100
42,561200,0000000401256,00001744,1000,1000,0,1000,762,238,1744,1744,0,0,1744,1680,133,1526,6,3,3,9,64,47,16,0,1,0,1744,24,1720,1744,785,959,133,42,003,561200
42,561400,0000001852825,00004775,2644,2644,0,2644,2493,151,4775,4775,0,0,4775,4669,1366,3230,6,32,1,34,106,90,16,0,0,0,4775,43,4732,4775,2053,2722,1366,42,003,561400
42,561500,0000001300623,00003655,1850,1850,0,1850,1646,204,3655,3655,0,0,3655,3586,1112,2380,12,57,5,20,69,58,10,0,1,0,3655,43,3612,3655,1645,2010,1112,42,003,561500
42,980100,0000265408720,00004902,2101,2101,0,2101,1869,232,4902,4902,0,0,4902,4880,4867,9,2,0,1,1,22,22,0,0,0,0,4902,6,4896,4902,2395,2507,4867,42,005,980100
42,980200,0000148212089,00002471,1545,1545,0,1545,953,592,2471,2471,0,0,2471,2463,2453,5,1,0,3,1,8,8,0,0,0,0,2471,10,2461,2471,1255,1216,2453,42,005,980200
42,980300,0000150090908,00003792,1868,1868,0,1868,1416,452,3792,3792,0,0,3792,3783,3732,48,1,2,0,0,9,8,1,0,0,0,3792,9,3783,3792,1903,1889,3732,42,005,980300
42,980400,0000069531091,00002713,1123,1123,0,1123,1055,68,2713,2713,0,0,2713,2706,2692,2,0,4,0,8,7,7,0,0,0,0,2713,17,2696,2713,1317,1396,2692,42,005,980400
42,980500,0000081073915,00005455,2388,2388,0,2388,2233,155,5455,5455,0,0,5455,5429,5398,4,8,15,1,3,26,26,0,0,0,0,5455,25,5430,5455,2590,2865,5398,42,005,980500
42,980600,0000131363532,00003471,1521,1521,0,1521,1304,217,3471,3471,0,0,3471,3461,3429,7,11,3,0,11,10,10,0,0,0,0,3471,17,3454,3471,1713,1758,3429,42,005,980600
42,980700,0000129063945,00004040,1667,1667,0,1667,1545,122,4040,4040,0,0,4040,4026,4006,8,4,4,0,4,14,14,0,0,0,0,4040,15,4025,4040,2001,2039,4006,42,005,980700
42,980800,0000174339248,00004398,1917,1917,0,1917,1671,246,4398,4398,0,0,4398,4385,4375,6,2,2,0,0,13,12,1,0,0,0,4398,19,4379,4398,2204,2194,4375,42,005,980800
42,980900,0000043456546,00005044,2254,2254,0,2254,2113,141,5044,5044,0,0,5044,5016,4974,27,5,5,1,4,28,25,3,0,0,0,5044,21,5023,5044,2439,2605,4974,42,005,980900
42,981000,0000001837285,00003451,1713,1713,0,1713,1580,133,3451,3451,0,0,3451,3407,3257,134,5,6,0,5,44,43,1,0,0,0,3451,26,3425,3451,1580,1871,3257,42,005,981000
42,981100,0000002686405,00004787,2251,2251,0,2251,2032,219,4787,4787,0,0,4787,4760,4658,75,11,12,0,4,27,26,1,0,0,0,4787,32,4755,4787,2164,2623,4658,42,005,981100
42,981200,0000136538429,00006117,2432,2432,0,2432,2339,93,6117,6117,0,0,6117,6095,6078,9,0,7,1,0,22,22,0,0,0,0,6117,18,6099,6117,3096,3021,6078,42,005,981200
42,981300,0000042682204,00002587,1114,1114,0,1114,1034,80,2587,2587,0,0,2587,2571,2535,26,1,5,3,1,16,14,2,0,0,0,2587,5,2582,2587,1301,1286,2535,42,005,981300
42,981400,0000036499076,00002754,1186,1186,0,1186,1108,78,2754,2754,0,0,2754,2737,2622,89,1,0,0,25,17,17,0,0,0,0,2754,17,2737,2754,1360,1394,2622,42,005,981400
42,981500,0000002206940,00003191,1482,1482,0,1482,1345,137,3191,3191,0,0,3191,3166,3072,80,4,4,2,4,25,24,1,0,0,0,3191,16,3175,3191,1509,1682,3072,42,005,981500
42,981600,0000105527775,00004950,2074,2074,0,2074,1931,143,4950,4950,0,0,4950,4920,4865,24,6,11,0,14,30,30,0,0,0,0,4950,25,4925,4950,2434,2516,4865,42,005,981600
42,981700,0000168997492,00003921,1614,1614,0,1614,1490,124,3921,3921,0,0,3921,3912,3902,4,3,0,0,3,9,8,1,0,0,0,3921,5,3916,3921,1949,1972,3902,42,005,981700
42,981800,0000001161398,00002386,1193,1193,0,1193,1109,84,2386,2386,0,0,2386,2363,2327,30,1,4,0,1,23,21,2,0,0,0,2386,16,2370,2386,1087,1299,2327,42,005,981800
42,981900,0000002992884,00001962,944,944,0,944,878,66,1962,1962,0,0,1962,1950,1931,5,0,5,1,8,12,11,1,0,0,0,1962,9,1953,1962,907,1055,1931,42,005,981900
42,600101,0000045629712,00004307,1715,1715,0,1715,1600,115,4307,4307,0,0,4307,4296,4277,5,5,6,0,3,11,11,0,0,0,0,4307,24,4283,4307,2134,2173,4277,42,007,600101
42,600102,0000026593465,00000940,388,388,0,388,361,27,940,940,0,0,940,930,923,6,0,0,1,0,10,9,1,0,0,0,940,7,933,940,467,473,923,42,007,600102
42,600200,0000053792124,00006120,2326,2326,0,2326,2238,88,6120,6120,0,0,6120,6082,6010,55,1,12,1,3,38,36,0,0,2,0,6120,20,6100,6120,2969,3151,6010,42,007,600200
42,600300,0000000830134,00000732,327,327,0,327,307,20,732,732,0,0,732,730,726,0,0,0,0,4,2,2,0,0,0,0,732,8,724,732,365,367,726,42,007,600300
42,600400,0000001369401,00000856,409,409,0,409,373,36,856,856,0,0,856,845,841,4,0,0,0,0,11,5,6,0,0,0,856,3,853,856,407,449,841,42,007,600400
42,600500,0000047317836,00002757,1156,1156,0,1156,1102,54,2757,2757,0,0,2757,2736,2685,27,15,5,0,4,21,21,0,0,0,0,2757,21,2736,2757,1334,1423,2685,42,007,600500
42,600601,0000057324314,00002273,977,977,0,977,904,73,2273,2273,0,0,2273,2266,2256,2,4,2,0,2,7,7,0,0,0,0,2273,5,2268,2273,1111,1162,2256,42,007,600601
42,600602,0000077700362,00002974,1139,1139,0,1139,1090,49,2974,2974,0,0,2974,2964,2915,37,3,6,0,3,10,10,0,0,0,0,2974,11,2963,2974,1430,1544,2915,42,007,600602
42,600700,0000041139580,00007021,2933,2933,0,2933,2807,126,7021,7021,0,0,7021,6973,6853,65,1,43,2,9,48,47,1,0,0,0,7021,19,7002,7021,3434,3587,6853,42,007,600700
42,600800,0000002029492,00001187,499,499,0,499,469,30,1187,1187,0,0,1187,1184,1153,24,1,1,0,5,3,3,0,0,0,0,1187,5,1182,1187,553,634,1153,42,007,600800
42,600900,0000001877593,00001434,667,667,0,667,628,39,1434,1434,0,0,1434,1415,1252,143,5,6,3,6,19,16,3,0,0,0,1434,12,1422,1434,656,778,1252,42,007,600900
42,601000,0000004980166,00003867,1600,1600,0,1600,1517,83,3867,3867,0,0,3867,3828,3761,49,5,5,0,8,39,38,1,0,0,0,3867,30,3837,3867,1816,2051,3761,42,007,601000
42,601100,0000001914838,00003562,1214,1214,0,1214,1133,81,3562,3562,0,0,3562,3488,3119,290,6,50,0,23,74,73,1,0,0,0,3562,40,3522,3562,1663,1899,3119,42,007,601100
42,601200,0000002469069,00003351,1808,1808,0,1808,1492,316,3351,3351,0,0,3351,3259,2392,844,6,9,2,6,92,83,9,0,0,0,3351,21,3330,3351,1521,1830,2392,42,007,601200
42,601300,0000001104061,00003007,1358,1358,0,1358,1173,185,3007,3007,0,0,3007,2938,2308,605,1,3,0,21,69,63,5,1,0,0,3007,44,2963,3007,1354,1653,2308,42,007,601300
42,601400,0000001450186,00003754,1651,1651,0,1651,1500,151,3754,3754,0,0,3754,3681,3327,331,9,11,0,3,73,64,9,0,0,0,3754,16,3738,3754,1809,1945,3327,42,007,601400
42,601500,0000002387948,00003194,1484,1484,0,1484,1366,118,3194,3194,0,0,3194,3102,2690,387,7,2,0,16,92,86,6,0,0,0,3194,17,3177,3194,1454,1740,2690,42,007,601500
42,601600,0000002133653,00001674,764,764,0,764,726,38,1674,1674,0,0,1674,1659,1597,53,4,3,0,2,15,14,1,0,0,0,1674,9,1665,1674,787,887,1597,42,007,601600
42,601700,0000026059676,00003734,1450,1450,0,1450,1394,56,3734,3734,0,0,3734,3710,3625,68,6,5,2,4,24,24,0,0,0,0,3734,8,3726,3734,1836,1898,3625,42,007,601700
42,601800,0000084612394,00007076,2879,2879,0,2879,2736,143,7076,7076,0,0,7076,7037,7004,12,9,11,0,1,39,36,2,0,1,0,7076,24,7052,7076,3542,3534,7004,42,007,601800
42,601900,0000009884383,00003129,1268,1268,0,1268,1213,55,3129,3129,0,0,3129,3097,2977,114,3,3,0,0,32,31,1,0,0,0,3129,6,3123,3129,1541,1588,2977,42,007,601900
42,602000,0000001028830,00000623,293,293,0,293,283,10,623,623,0,0,623,619,597,22,0,0,0,0,4,4,0,0,0,0,623,1,622,623,293,330,597,42,007,602000
42,602100,0000001515150,00004014,1900,1900,0,1900,1732,168,4014,4014,0,0,4014,3941,3364,537,9,8,0,23,73,70,3,0,0,0,4014,37,3977,4014,1850,2164,3364,42,007,602100
42,602200,0000001791310,00000739,361,361,0,361,335,26,739,739,0,0,739,729,658,65,1,3,0,2,10,10,0,0,0,0,739,4,735,739,350,389,658,42,007,602200
42,602300,0000001237070,00002621,1356,1356,0,1356,1232,124,2621,2621,0,0,2621,2611,2548,35,6,13,0,9,10,10,0,0,0,0,2621,21,2600,2621,1188,1433,2548,42,007,602300
42,602400,0000001178735,00002154,941,941,0,941,880,61,2154,2154,0,0,2154,2152,2057,91,0,0,0,4,2,2,0,0,0,0,2154,21,2133,2154,1092,1062,2057,42,007,602400
42,602500,0000002422702,00001451,827,827,0,827,775,52,1451,1451,0,0,1451,1445,1423,20,0,2,0,0,6,6,0,0,0,0,1451,7,1444,1451,622,829,1423,42,007,602500
42,602601,0000035294406,00004194,1599,1599,0,1599,1549,50,4194,4194,0,0,4194,4172,4142,8,3,16,0,3,22,21,1,0,0,0,4194,24,4170,4194,2073,2121,4142,42,007,602601
42,602602,0000013945867,00003830,1276,1276,0,1276,1234,42,3830,3830,0,0,3830,3819,3718,78,1,19,1,2,11,11,0,0,0,0,3830,25,3805,3830,1683,2147,3718,42,007,602602
42,602701,0000025489716,00001921,816,816,0,816,772,44,1921,1921,0,0,1921,1913,1861,37,1,3,0,11,8,8,0,0,0,0,1921,27,1894,1921,954,967,1861,42,007,602701
42,602702,0000060715196,00003822,1467,1467,0,1467,1398,69,3822,3822,0,0,3822,3802,3714,75,1,3,0,9,20,19,1,0,0,0,3822,30,3792,3822,1886,1936,3714,42,007,602702
42,602800,0000005285636,00003137,1651,1651,0,1651,1424,227,3137,3137,0,0,3137,3071,2375,654,14,0,0,28,66,63,3,0,0,0,3137,116,3021,3137,1419,1718,2375,42,007,602800
42,602900,0000073758306,00003276,1239,1239,0,1239,1169,70,3276,3276,0,0,3276,3241,3219,7,8,3,1,3,35,35,0,0,0,0,3276,22,3254,3276,1662,1614,3219,42,007,602900
42,603000,0000047998462,00003397,1227,1227,0,1227,1186,41,3397,3397,0,0,3397,3375,3353,13,5,1,0,3,22,21,1,0,0,0,3397,24,3373,3397,1698,1699,3353,42,007,603000
42,603100,0000015873963,00000580,222,222,0,222,210,12,580,580,0,0,580,577,575,0,2,0,0,0,3,3,0,0,0,0,580,0,580,580,298,282,575,42,007,603100
42,603201,0000011069355,00005079,2036,2036,0,2036,1947,89,5079,5079,0,0,5079,5056,4850,160,8,31,0,7,23,20,3,0,0,0,5079,40,5039,5079,2503,2576,4850,42,007,603201
42,603202,0000028804856,00006413,2402,2402,0,2402,2323,79,6413,6413,0,0,6413,6372,6167,181,2,15,0,7,41,37,4,0,0,0,6413,40,6373,6413,3213,3200,6167,42,007,603202
42,603300,0000003584781,00004141,1789,1789,0,1789,1731,58,4141,4141,0,0,4141,4115,4010,95,0,8,0,2,26,26,0,0,0,0,4141,27,4114,4141,1915,2226,4010,42,007,603300
42,603400,0000001834857,00002145,1103,1103,0,1103,978,125,2145,2145,0,0,2145,2129,2095,27,0,6,0,1,16,16,0,0,0,0,2145,11,2134,2145,1014,1131,2095,42,007,603400
42,603500,0000001530006,00001763,731,731,0,731,687,44,1763,1763,0,0,1763,1736,1636,91,1,4,0,4,27,26,1,0,0,0,1763,13,1750,1763,853,910,1636,42,007,603500
42,603600,0000003249387,00002290,1026,1026,0,1026,988,38,2290,2290,0,0,2290,2281,2250,29,1,0,0,1,9,9,0,0,0,0,2290,11,2279,2290,1081,1209,2250,42,007,603600
42,603700,0000005923357,00004377,1986,1986,0,1986,1900,86,4377,4377,0,0,4377,4359,4315,32,2,6,0,4,18,17,1,0,0,0,4377,25,4352,4377,1995,2382,4315,42,007,603700
42,603801,0000010455972,00003052,1079,1079,0,1079,1056,23,3052,3052,0,0,3052,3040,2973,44,2,14,0,7,12,12,0,0,0,0,3052,12,3040,3052,1542,1510,2973,42,007,603801
42,603802,0000010036410,00002859,1061,1061,0,1061,1042,19,2859,2859,0,0,2859,2844,2815,12,6,8,0,3,15,15,0,0,0,0,2859,17,2842,2859,1405,1454,2815,42,007,603802
42,603803,0000025347486,00003452,1489,1489,0,1489,1430,59,3452,3452,0,0,3452,3432,3419,6,1,4,0,2,20,20,0,0,0,0,3452,12,3440,3452,1726,1726,3419,42,007,603803
42,603900,0000007426777,00003373,1509,1509,0,1509,1439,70,3373,3373,0,0,3373,3352,3288,49,0,4,4,7,21,19,2,0,0,0,3373,19,3354,3373,1605,1768,3288,42,007,603900
42,604000,0000001251790,00002832,1361,1361,0,1361,1254,107,2832,2832,0,0,2832,2784,2439,313,3,10,0,19,48,43,5,0,0,0,2832,53,2779,2832,1308,1524,2439,42,007,604000
42,604100,0000001390978,00003156,1748,1748,0,1748,1461,287,3156,3156,0,0,3156,3101,2590,470,1,17,0,23,55,52,3,0,0,0,3156,57,3099,3156,1502,1654,2590,42,007,604100
42,604200,0000001202524,00001781,990,990,0,990,880,110,1781,1781,0,0,1781,1755,1628,101,2,8,1,15,26,18,4,1,3,0,1781,32,1749,1781,861,920,1628,42,007,604200
42,604300,0000004482819,00002631,1211,1211,0,1211,1029,182,2631,2631,0,0,2631,2603,1796,795,2,5,2,3,28,28,0,0,0,0,2631,33,2598,2631,1253,1378,1796,42,007,604300
42,604400,0000000698328,00000605,322,322,0,322,284,38,605,605,0,0,605,594,592,0,1,0,0,1,11,11,0,0,0,0,605,6,599,605,298,307,592,42,007,604400
42,604500,0000002138713,00003456,1787,1787,0,1787,1449,338,3456,3456,0,0,3456,3382,526,2843,3,2,2,6,74,58,16,0,0,0,3456,30,3426,3456,1481,1975,526,42,007,604500
42,604600,0000002568754,00003476,1721,1721,0,1721,1616,105,3476,3476,0,0,3476,3434,2999,420,2,7,0,6,42,42,0,0,0,0,3476,37,3439,3476,1552,1924,2999,42,007,604600
42,604700,0000000709176,00001566,802,802,0,802,746,56,1566,1566,0,0,1566,1553,1431,110,0,7,0,5,13,13,0,0,0,0,1566,11,1555,1566,728,838,1431,42,007,604700
42,604800,0000010342696,00004723,2033,2033,0,2033,1973,60,4723,4723,0,0,4723,4704,4611,88,0,4,0,1,19,19,0,0,0,0,4723,17,4706,4723,2212,2511,4611,42,007,604800
42,604901,0000025361260,00003974,1676,1676,0,1676,1592,84,3974,3974,0,0,3974,3956,3839,98,1,11,2,5,18,17,1,0,0,0,3974,29,3945,3974,1890,2084,3839,42,007,604901
42,604902,0000009002717,00005099,2183,2183,0,2183,2120,63,5099,5099,0,0,5099,5073,4986,58,0,28,0,1,26,26,0,0,0,0,5099,21,5078,5099,2419,2680,4986,42,007,604902
42,605001,0000059229704,00002802,1069,1069,0,1069,1007,62,2802,2802,0,0,2802,2754,2741,5,3,0,0,5,48,48,0,0,0,0,2802,17,2785,2802,1420,1382,2741,42,007,605001
42,605002,0000116828351,00003659,1464,1464,0,1464,1336,128,3659,3659,0,0,3659,3639,3599,21,7,5,0,7,20,15,5,0,0,0,3659,36,3623,3659,1833,1826,3599,42,007,605002
42,980100,0000130804848,00003747,1613,1613,0,1613,1446,167,3747,3747,0,0,3747,3725,3685,5,4,16,0,15,22,20,2,0,0,0,3747,26,3721,3747,1769,1978,3685,42,009,980100
42,980200,0000191933873,00003578,1734,1734,0,1734,1360,374,3578,3578,0,0,3578,3565,3554,4,5,1,0,1,13,13,0,0,0,0,3578,12,3566,3578,1790,1788,3554,42,009,980200
42,980300,0000165531285,00005067,2212,2212,0,2212,1911,301,5067,5067,0,0,5067,5038,4976,21,3,24,0,14,29,29,0,0,0,0,5067,32,5035,5067,2537,2530,4976,42,009,980300
42,980400,0000227586879,00005089,2095,2095,0,2095,1890,205,5089,5089,0,0,5089,5066,5053,4,3,3,0,3,23,23,0,0,0,0,5089,23,5066,5089,2523,2566,5053,42,009,980400
42,980500,0000255644581,00003831,1837,1837,0,1837,1507,330,3831,3831,0,0,3831,3814,3795,7,5,7,0,0,17,17,0,0,0,0,3831,20,3811,3831,1934,1897,3795,42,009,980500
42,980600,0000102444969,00005228,2557,2557,0,2557,2215,342,5228,5228,0,0,5228,5204,5165,20,1,8,2,8,24,19,1,0,4,0,5228,23,5205,5228,2502,2726,5165,42,009,980600
42,980700,0000002873788,00003141,1640,1640,0,1640,1536,104,3141,3141,0,0,3141,3118,3069,16,2,24,3,4,23,22,1,0,0,0,3141,25,3116,3141,1403,1738,3069,42,009,980700
42,980800,0000177657419,00005417,2403,2403,0,2403,2144,259,5417,5417,0,0,5417,5376,5262,72,3,26,0,13,41,40,1,0,0,0,5417,32,5385,5417,2693,2724,5262,42,009,980800
42,980900,0000372614323,00004989,2697,2697,0,2697,1947,750,4989,4989,0,0,4989,4967,4928,14,4,12,2,7,22,22,0,0,0,0,4989,31,4958,4989,2516,2473,4928,42,009,980900
42,981000,0000703556416,00005638,2784,2784,0,2784,2118,666,5638,5638,0,0,5638,5602,5557,13,11,14,0,7,36,36,0,0,0,0,5638,21,5617,5638,2824,2814,5557,42,009,981000
42,981100,0000296922032,00004259,1957,1957,0,1957,1694,263,4259,4259,0,0,4259,4238,4209,2,13,8,0,6,21,21,0,0,0,0,4259,18,4241,4259,2140,2119,4209,42,009,981100
42,000100,0000000804286,00005110,2766,2766,0,2766,2330,436,5110,5110,0,0,5110,4883,2338,706,43,99,3,1694,227,218,6,3,0,0,5110,2644,2466,5110,2492,2618,2338,42,011,000100
42,000200,0000001906888,00003612,1674,1674,0,1674,1621,53,3612,3612,0,0,3612,3446,1906,610,21,56,1,852,166,158,7,1,0,0,3612,1558,2054,3612,1552,2060,1906,42,011,000200
42,000300,0000001476622,00001915,765,765,0,765,699,66,1915,1915,0,0,1915,1838,1273,274,3,79,0,209,77,68,9,0,0,0,1915,395,1520,1915,964,951,1273,42,011,000300
42,000400,0000001766533,00003411,1407,1407,0,1407,1292,115,3411,3411,0,0,3411,3262,2356,334,15,56,2,499,149,144,4,0,1,0,3411,902,2509,3411,1651,1760,2356,42,011,000400
42,000500,0000001233899,00003119,1279,1279,0,1279,1188,91,3119,3119,0,0,3119,3024,2413,195,1,35,0,380,95,90,5,0,0,0,3119,580,2539,3119,1494,1625,2413,42,011,000500
42,000600,0000001520303,00003370,1121,1121,0,1121,1063,58,3370,3370,0,0,3370,3325,2928,202,9,107,3,76,45,43,2,0,0,0,3370,159,3211,3370,1570,1800,2928,42,011,000600
42,000700,0000000613157,00003602,1403,1403,0,1403,1294,109,3602,3602,0,0,3602,3481,2739,268,4,35,3,432,121,115,6,0,0,0,3602,678,2924,3602,1766,1836,2739,42,011,000700
42,000800,0000000303924,00003640,1444,1444,0,1444,1288,156,3640,3640,0,0,3640,3515,2462,279,12,93,2,667,125,102,23,0,0,0,3640,1188,2452,3640,1819,1821,2462,42,011,000800
42,000900,0000000459096,00002378,1184,1184,0,1184,1022,162,2378,2378,0,0,2378,2282,1483,392,11,28,2,366,96,89,7,0,0,0,2378,610,1768,2378,1193,1185,1483,42,011,000900
42,001000,0000000255330,00002982,1129,1129,0,1129,948,181,2982,2982,0,0,2982,2790,1162,671,14,45,0,898,192,186,6,0,0,0,2982,1371,1611,2982,1445,1537,1162,42,011,001000
42,001100,0000000778540,00003834,1442,1442,0,1442,1177,265,3834,3834,0,0,3834,3645,1715,841,10,25,1,1053,189,181,5,0,1,2,3834,1881,1953,3834,1863,1971,1715,42,011,001100
42,001200,0000000156708,00001900,645,645,0,645,522,123,1900,1900,0,0,1900,1807,510,581,33,7,0,676,93,92,1,0,0,0,1900,1119,781,1900,967,933,510,42,011,001200
42,001300,0000000577502,00003011,1340,1340,0,1340,1094,246,3011,3011,0,0,3011,2856,1209,664,19,14,1,949,155,148,7,0,0,0,3011,1751,1260,3011,1496,1515,1209,42,011,001300
42,001400,0000000374313,00004060,1647,1647,0,1647,1367,280,4060,4060,0,0,4060,3886,1981,402,14,57,1,1431,174,161,13,0,0,0,4060,2176,1884,4060,2038,2022,1981,42,011,001400
42,001500,0000000232939,00003080,1141,1141,0,1141,1023,118,3080,3080,0,0,3080,2940,1965,286,7,34,5,643,140,135,5,0,0,0,3080,1080,2000,3080,1509,1571,1965,42,011,001500
42,001600,0000000247937,00002358,939,939,0,939,840,99,2358,2358,0,0,2358,2257,1575,182,19,41,0,440,101,99,2,0,0,0,2358,752,1606,2358,1137,1221,1575,42,011,001600
42,001700,0000000366894,00002954,1249,1249,0,1249,956,293,2954,2954,0,0,2954,2795,1406,256,25,77,0,1031,159,141,7,0,11,0,2954,1728,1226,2954,1491,1463,1406,42,011,001700
42,001800,0000003120291,00002597,1244,1244,0,1244,1137,107,2597,2597,0,0,2597,2528,2115,176,6,32,0,199,69,63,6,0,0,0,2597,361,2236,2597,1241,1356,2115,42,011,001800
42,001900,0000000175023,00002399,1301,1301,0,1301,1073,228,2399,2399,0,0,2399,2282,1345,251,8,72,0,606,117,102,15,0,0,0,2399,1031,1368,2399,1151,1248,1345,42,011,001900
42,002000,0000000777152,00003784,1717,1717,0,1717,1536,181,3784,3784,0,0,3784,3661,3008,275,9,32,0,337,123,120,3,0,0,0,3784,655,3129,3784,1824,1960,3008,42,011,002000
42,002100,0000000479143,00002745,1136,1136,0,1136,962,174,2745,2745,0,0,2745,2628,1743,298,8,18,1,560,117,114,3,0,0,0,2745,911,1834,2745,1320,1425,1743,42,011,002100
42,002200,0000000536843,00002066,807,807,0,807,671,136,2066,2066,0,0,2066,1904,875,238,8,21,3,759,162,156,6,0,0,0,2066,1239,827,2066,1071,995,875,42,011,002200
42,002300,0000000276053,00002118,916,916,0,916,738,178,2118,2118,0,0,2118,2014,948,276,6,20,0,764,104,103,1,0,0,0,2118,1181,937,2118,1098,1020,948,42,011,002300
42,002500,0000001180928,00003599,1584,1584,0,1584,1400,184,3599,3599,0,0,3599,3455,1460,744,20,92,2,1137,144,141,3,0,0,0,3599,2057,1542,3599,1688,1911,1460,42,011,002500
42,002600,0000001498892,00003183,1129,1129,0,1129,1069,60,3183,3183,0,0,3183,3016,1291,321,20,47,0,1337,167,161,6,0,0,0,3183,1978,1205,3183,1389,1794,1291,42,011,002600
42,002700,0000001492961,00001928,937,937,0,937,889,48,1928,1928,0,0,1928,1884,1680,113,2,41,0,48,44,44,0,0,0,0,1928,144,1784,1928,866,1062,1680,42,011,002700
42,002900,0000002885515,00002453,969,969,0,969,915,54,2453,2453,0,0,2453,2412,2174,112,9,33,2,82,41,41,0,0,0,0,2453,173,2280,2453,1110,1343,2174,42,011,002900
42,010100,0000169022220,00006000,2284,2284,0,2284,2143,141,6000,6000,0,0,6000,5965,5854,32,6,36,1,36,35,33,2,0,0,0,6000,92,5908,6000,3073,2927,5854,42,011,010100
42,010200,0000152268758,00008990,3505,3505,0,3505,3290,215,8990,8990,0,0,8990,8931,8792,41,8,28,0,62,59,57,2,0,0,0,8990,127,8863,8990,4554,4436,8792,42,011,010200
42,010301,0000051473294,00008563,2682,2682,0,2682,2598,84,8563,8563,0,0,8563,8494,8028,321,9,99,0,37,69,69,0,0,0,0,8563,585,7978,8563,4610,3953,8028,42,011,010301
42,010302,0000049180588,00002858,1116,1116,0,1116,1065,51,2858,2858,0,0,2858,2839,2789,20,2,10,0,18,19,19,0,0,0,0,2858,53,2805,2858,1427,1431,2789,42,011,010302
42,010400,0000176530529,00007792,2693,2693,0,2693,2585,108,7792,7792,0,0,7792,7731,7470,144,9,19,0,89,61,57,4,0,0,0,7792,185,7607,7792,4108,3684,7470,42,011,010400
42,010500,0000041674427,00006271,2583,2583,0,2583,2478,105,6271,6271,0,0,6271,6234,6023,80,0,59,0,72,37,35,2,0,0,0,6271,126,6145,6271,3081,3190,6023,42,011,010500
42,010600,0000040770895,00006300,2448,2448,0,2448,2387,61,6300,6300,0,0,6300,6271,6140,54,6,54,0,17,29,26,3,0,0,0,6300,62,6238,6300,3043,3257,6140,42,011,010600
42,010700,0000035637519,00005491,2027,2027,0,2027,1947,80,5491,5491,0,0,5491,5459,5310,80,2,25,0,42,32,32,0,0,0,0,5491,86,5405,5491,2819,2672,5310,42,011,010700
42,010800,0000033385497,00009119,3413,3413,0,3413,3305,108,9119,9119,0,0,9119,8994,8319,325,6,211,1,132,125,124,1,0,0,0,9119,363,8756,9119,4385,4734,8319,42,011,010800
42,010902,0000003486066,00002639,1269,1269,0,1269,1233,36,2639,2639,0,0,2639,2612,2527,28,4,21,0,32,27,26,1,0,0,0,2639,72,2567,2639,1249,1390,2527,42,011,010902
42,010903,0000009146772,00004901,2176,2176,0,2176,2107,69,4901,4901,0,0,4901,4876,4692,49,5,92,1,37,25,22,3,0,0,0,4901,106,4795,4901,2323,2578,4692,42,011,010903
42,010904,0000002033238,00003506,1440,1440,0,1440,1415,25,3506,3506,0,0,3506,3472,3291,33,1,137,0,10,34,34,0,0,0,0,3506,55,3451,3506,1682,1824,3291,42,011,010904
42,010905,0000002633477,00004281,1967,1967,0,1967,1913,54,4281,4281,0,0,4281,4225,4098,51,2,30,0,44,56,48,8,0,0,0,4281,108,4173,4281,2065,2216,4098,42,011,010905
42,011000,0000002400909,00004165,1741,1741,0,1741,1692,49,4165,4165,0,0,4165,4130,3931,48,4,115,0,32,35,34,1,0,0,0,4165,76,4089,4165,2003,2162,3931,42,011,011000
42,011100,0000009901992,00008587,3539,3539,0,3539,3359,180,8587,8587,0,0,8587,8513,8137,129,6,163,2,76,74,69,5,0,0,0,8587,157,8430,8587,3917,4670,8137,42,011,011100
42,011200,0000001481281,00004049,1783,1783,0,1783,1666,117,4049,4049,0,0,4049,3990,3617,163,9,62,1,138,59,58,1,0,0,0,4049,315,3734,4049,1831,2218,3617,42,011,011200
42,011300,0000001524373,00002679,1254,1254,0,1254,1215,39,2679,2679,0,0,2679,2662,2568,22,1,43,0,28,17,16,1,0,0,0,2679,54,2625,2679,1296,1383,2568,42,011,011300
42,011400,0000002639355,00005059,2321,2321,0,2321,2238,83,5059,5059,0,0,5059,5008,4913,25,5,27,0,38,51,48,3,0,0,0,5059,106,4953,5059,2394,2665,4913,42,011,011400
42,011500,0000002259785,00002963,1259,1259,0,1259,1211,48,2963,2963,0,0,2963,2942,2868,33,2,13,0,26,21,21,0,0,0,0,2963,50,2913,2963,1402,1561,2868,42,011,011500
42,011601,0000005062750,00005069,2212,2212,0,2212,2155,57,5069,5069,0,0,5069,4992,4557,151,1,149,3,131,77,73,2,2,0,0,5069,234,4835,5069,2319,2750,4557,42,011,011601
42,011602,0000023078618,00003907,1623,1623,0,1623,1566,57,3907,3907,0,0,3907,3883,3743,48,4,56,2,30,24,21,3,0,0,0,3907,91,3816,3907,1910,1997,3743,42,011,011602
42,011603,0000025358176,00004839,2291,2291,0,2291,2219,72,4839,4839,0,0,4839,4803,4664,66,3,55,1,14,36,35,1,0,0,0,4839,64,4775,4839,2400,2439,4664,42,011,011603
42,011701,0000087798160,00006869,2568,2568,0,2568,2488,80,6869,6869,0,0,6869,6824,6724,22,14,17,2,45,45,44,1,0,0,0,6869,60,6809,6869,3469,3400,6724,42,011,011701
42,011702,0000046200913,00004459,1611,1611,0,1611,1558,53,4459,4459,0,0,4459,4417,4363,27,6,10,0,11,42,37,5,0,0,0,4459,41,4418,4459,2266,2193,4363,42,011,011702
42,011703,0000037413034,00002347,937,937,0,937,900,37,2347,2347,0,0,2347,2326,2290,9,0,22,0,5,21,21,0,0,0,0,2347,20,2327,2347,1165,1182,2290,42,011,011703
42,011800,0000003597094,00005064,1927,1927,0,1927,1854,73,5064,5064,0,0,5064,5017,4905,53,6,18,3,32,47,45,2,0,0,0,5064,63,5001,5064,2517,2547,4905,42,011,011800
42,011901,0000047395572,00008867,3323,3323,0,3323,3219,104,8867,8867,0,0,8867,8776,8484,181,17,59,1,34,91,88,3,0,0,0,8867,89,8778,8867,4380,4487,8484,42,011,011901
42,011902,0000060059372,00003453,1370,1370,0,1370,1324,46,3453,3453,0,0,3453,3425,3385,20,5,4,1,10,28,28,0,0,0,0,3453,33,3420,3453,1729,1724,3385,42,011,011902
42,012001,0000008251961,00002624,1093,1093,0,1093,1027,66,2624,2624,0,0,2624,2583,2441,121,2,8,3,8,41,41,0,0,0,0,2624,42,2582,2624,1298,1326,2441,42,011,012001
42,012002,0000010161520,00007251,2860,2860,0,2860,2775,85,7251,7251,0,0,7251,7200,6933,151,6,91,0,19,51,48,3,0,0,0,7251,102,7149,7251,3537,3714,6933,42,011,012002
42,012101,0000002350278,00001812,781,781,0,781,757,24,1812,1812,0,0,1812,1784,1730,39,0,14,0,1,28,25,3,0,0,0,1812,33,1779,1812,873,939,1730,42,011,012101
42,012102,0000018884410,00009093,3422,3422,0,3422,3322,100,9093,9093,0,0,9093,9038,8671,145,9,127,0,86,55,55,0,0,0,0,9093,209,8884,9093,4436,4657,8671,42,011,012102
42,012103,0000025869551,00002193,833,833,0,833,810,23,2193,2193,0,0,2193,2179,2136,16,5,19,0,3,14,13,1,0,0,0,2193,21,2172,2193,1080,1113,2136,42,011,012103
42,012200,0000002687522,00003113,1373,1373,0,1373,1316,57,3113,3113,0,0,3113,3085,3001,32,1,32,0,19,28,23,2,3,0,0,3113,106,3007,3113,1490,1623,3001,42,011,012200
42,012300,0000010613007,00004381,1918,1918,0,1918,1843,75,4381,4381,0,0,4381,4349,4232,31,0,40,0,46,32,32,0,0,0,0,4381,123,4258,4381,2135,2246,4232,42,011,012300
42,012400,0000014594014,00005067,2198,2198,0,2198,2095,103,5067,5067,0,0,5067,5006,4826,53,4,19,0,104,61,55,6,0,0,0,5067,270,4797,5067,2326,2741,4826,42,011,012400
42,012500,0000003787540,00001865,848,848,0,848,824,24,1865,1865,0,0,1865,1855,1819,10,0,12,0,14,10,10,0,0,0,0,1865,78,1787,1865,898,967,1819,42,011,012500
42,012600,0000002118270,00002096,891,891,0,891,849,42,2096,2096,0,0,2096,2071,1947,45,1,20,0,58,25,22,3,0,0,0,2096,131,1965,2096,1040,1056,1947,42,011,012600
42,012700,0000010619503,00007277,2960,2960,0,2960,2871,89,7277,7277,0,0,7277,7226,6976,90,1,64,0,95,51,49,2,0,0,0,7277,159,7118,7277,3523,3754,6976,42,011,012700
42,012800,0000002107902,00003759,1685,1685,0,1685,1636,49,3759,3759,0,0,3759,3726,3605,28,2,14,1,76,33,30,3,0,0,0,3759,204,3555,3759,1777,1982,3605,42,011,012800
42,012900,0000094263250,00007272,2928,2928,0,2928,2815,113,7272,7272,0,0,7272,7242,7166,21,6,29,3,17,30,29,1,0,0,0,7272,71,7201,7272,3646,3626,7166,42,011,012900
42,013000,0000068661949,00006377,2441,2441,0,2441,2356,85,6377,6377,0,0,6377,6340,5960,332,5,21,2,20,37,34,2,1,0,0,6377,42,6335,6377,3261,3116,5960,42,011,013000
42,013100,0000021688737,00005270,2030,2030,0,2030,1994,36,5270,5270,0,0,5270,5244,5201,10,4,18,7,4,26,26,0,0,0,0,5270,18,5252,5270,2583,2687,5201,42,011,013100
42,013200,0000002064980,00003940,1885,1885,0,1885,1805,80,3940,3940,0,0,3940,3922,3894,8,1,14,0,5,18,18,0,0,0,0,3940,29,3911,3940,1893,2047,3894,42,011,013200
42,013300,0000079024524,00008521,3313,3313,0,3313,3161,152,8521,8521,0,0,8521,8472,8372,37,8,29,0,26,49,47,2,0,0,0,8521,72,8449,8521,4334,4187,8372,42,011,013300
42,013401,0000080225994,00007541,2789,2789,0,2789,2708,81,7541,7541,0,0,7541,7483,7429,15,3,21,0,15,58,56,2,0,0,0,7541,88,7453,7541,3804,3737,7429,42,011,013401
42,013402,0000066239395,00003126,1175,1175,0,1175,1127,48,3126,3126,0,0,3126,3123,3103,9,4,5,0,2,3,3,0,0,0,0,3126,9,3117,3126,1592,1534,3103,42,011,013402
42,013500,0000056563864,00007770,2912,2912,0,2912,2792,120,7770,7770,0,0,7770,7717,7502,59,7,89,0,60,53,53,0,0,0,0,7770,190,7580,7770,3903,3867,7502,42,011,013500
42,013600,0000002696195,00004018,1623,1623,0,1623,1584,39,4018,4018,0,0,4018,3996,3930,11,0,16,0,39,22,22,0,0,0,0,4018,69,3949,4018,1946,2072,3930,42,011,013600
42,013700,0000109818226,00008141,3139,3139,0,3139,2993,146,8141,8141,0,0,8141,8107,7895,77,10,25,2,98,34,31,3,0,0,0,8141,207,7934,8141,4120,4021,7895,42,011,013700
42,013800,0000004816585,00004114,1932,1932,0,1932,1824,108,4114,4114,0,0,4114,4080,4028,14,5,13,0,20,34,30,4,0,0,0,4114,34,4080,4114,1935,2179,4028,42,011,013800
42,013900,0000243596420,00007613,3037,3037,0,3037,2783,254,7613,7613,0,0,7613,7564,7493,29,9,15,0,18,49,48,1,0,0,0,7613,63,7550,7613,3878,3735,7493,42,011,013900
42,014000,0000004112111,00005067,1940,1940,0,1940,1874,66,5067,5067,0,0,5067,5042,4915,50,5,45,0,27,25,23,2,0,0,0,5067,49,5018,5067,2420,2647,4915,42,011,014000
42,014100,0000068969706,00006486,1600,1600,0,1600,1551,49,6486,6486,0,0,6486,6433,6238,124,5,37,8,21,53,50,3,0,0,0,6486,93,6393,6486,2932,3554,6238,42,011,014100
42,014200,0000060789564,00007556,2939,2939,0,2939,2834,105,7556,7556,0,0,7556,7534,7475,19,9,18,0,13,22,21,1,0,0,0,7556,70,7486,7556,3674,3882,7475,42,011,014200
42,010101,0000187170042,00004162,1719,1719,0,1719,1613,106,4162,4162,0,0,4162,4146,4132,6,1,7,0,0,16,15,1,0,0,0,4162,10,4152,4162,2039,2123,4132,42,013,010101
42,010102,0000002573137,00002862,1403,1403,0,1403,1286,117,2862,2862,0,0,2862,2846,2820,14,3,3,0,6,16,15,1,0,0,0,2862,22,2840,2862,1255,1607,2820,42,013,010102
42,010103,0000002566107,00002632,1152,1152,0,1152,1083,69,2632,2632,0,0,2632,2623,2611,4,3,3,0,2,9,9,0,0,0,0,2632,8,2624,2632,1251,1381,2611,42,013,010103
42,010401,0000001197085,00002016,822,822,0,822,776,46,2016,2016,0,0,2016,2003,1992,2,1,4,0,4,13,9,4,0,0,0,2016,18,1998,2016,954,1062,1992,42,013,010401
42,010402,0000157395151,00006328,2661,2661,0,2661,2530,131,6328,6328,0,0,6328,6299,6265,6,11,11,1,5,29,25,4,0,0,0,6328,18,6310,6328,3135,3193,6265,42,013,010402
42,010500,0000076263649,00004046,1637,1637,0,1637,1579,58,4046,4046,0,0,4046,4021,3995,18,4,3,0,1,25,21,4,0,0,0,4046,12,4034,4046,1979,2067,3995,42,013,010500
42,010600,0000016207452,00002524,1017,1017,0,1017,967,50,2524,2524,0,0,2524,2514,2473,20,1,20,0,0,10,10,0,0,0,0,2524,10,2514,2524,1238,1286,2473,42,013,010600
42,010700,0000066463192,00006383,2762,2762,0,2762,2586,176,6383,6383,0,0,6383,6365,6291,32,3,29,2,8,18,17,1,0,0,0,6383,29,6354,6383,3092,3291,6291,42,013,010700
42,010800,0000165405536,00003740,1508,1508,0,1508,1426,82,3740,3740,0,0,3740,3718,3676,32,4,5,0,1,22,22,0,0,0,0,3740,14,3726,3740,1849,1891,3676,42,013,010800
42,010900,0000126063150,00007694,3036,3036,0,3036,2887,149,7694,7694,0,0,7694,7649,7467,32,3,141,0,6,45,44,1,0,0,0,7694,43,7651,7694,3781,3913,7467,42,013,010900
42,011001,0000126358370,00003944,1703,1703,0,1703,1555,148,3944,3944,0,0,3944,3932,3911,5,0,13,0,3,12,12,0,0,0,0,3944,6,3938,3944,1962,1982,3911,42,013,011001
42,011002,0000019471874,00004254,1659,1659,0,1659,1575,84,4254,4254,0,0,4254,4238,4180,41,0,14,3,0,16,16,0,0,0,0,4254,7,4247,4254,2163,2091,4180,42,013,011002
42,011100,0000036857866,00006070,2572,2572,0,2572,2462,110,6070,6070,0,0,6070,6041,5993,18,2,21,0,7,29,24,1,0,0,4,6070,29,6041,6070,2930,3140,5993,42,013,011100
42,011200,0000006149209,00005368,2392,2392,0,2392,2224,168,5368,5368,0,0,5368,5341,5271,44,9,14,0,3,27,27,0,0,0,0,5368,26,5342,5368,2519,2849,5271,42,013,011200
42,011300,0000146333267,00005774,2319,2319,0,2319,2230,89,5774,5774,0,0,5774,5753,5740,8,2,2,0,1,21,21,0,0,0,0,5774,17,5757,5774,2729,3045,5740,42,013,011300
42,011400,0000002073371,00002418,1087,1087,0,1087,1019,68,2418,2418,0,0,2418,2412,2392,4,1,9,5,1,6,6,0,0,0,0,2418,1,2417,2418,1158,1260,2392,42,013,011400
42,011500,0000104907854,00005500,2233,2233,0,2233,2111,122,5500,5500,0,0,5500,5470,5440,12,7,7,0,4,30,30,0,0,0,0,5500,11,5489,5500,2787,2713,5440,42,013,011500
42,011600,0000093019218,00003904,1697,1697,0,1697,1549,148,3904,3904,0,0,3904,3880,3863,6,3,1,0,7,24,24,0,0,0,0,3904,14,3890,3904,1866,2038,3863,42,013,011600
42,100200,0000002804043,00002341,1053,1053,0,1053,1028,25,2341,2341,0,0,2341,2330,2317,3,1,4,0,5,11,9,2,0,0,0,2341,8,2333,2341,1100,1241,2317,42,013,100200
42,100300,0000001208717,00003317,1506,1506,0,1506,1380,126,3317,3317,0,0,3317,3285,3188,91,0,5,1,0,32,28,3,0,1,0,3317,6,3311,3317,1554,1763,3188,42,013,100300
42,100400,0000000985402,00001831,746,746,0,746,683,63,1831,1831,0,0,1831,1804,1650,147,5,0,0,2,27,26,1,0,0,0,1831,13,1818,1831,879,952,1650,42,013,100400
42,100500,0000001111521,00003665,1522,1522,0,1522,1391,131,3665,3665,0,0,3665,3601,3383,182,5,11,2,18,64,62,2,0,0,0,3665,31,3634,3665,1744,1921,3383,42,013,100500
42,100600,0000001005860,00002936,1207,1207,0,1207,1160,47,2936,2936,0,0,2936,2916,2851,52,5,1,0,7,20,15,5,0,0,0,2936,17,2919,2936,1397,1539,2851,42,013,100600
42,100700,0000001392314,00002630,1043,1043,0,1043,924,119,2630,2630,0,0,2630,2574,2447,101,6,9,0,11,56,53,3,0,0,0,2630,32,2598,2630,1179,1451,2447,42,013,100700
42,100800,0000000989892,00002392,647,647,0,647,622,25,2392,2392,0,0,2392,2377,2238,87,1,35,0,16,15,14,0,1,0,0,2392,37,2355,2392,1140,1252,2238,42,013,100800
42,100900,0000002429441,00004596,1934,1934,0,1934,1790,144,4596,4596,0,0,4596,4565,4512,36,3,7,0,7,31,31,0,0,0,0,4596,34,4562,4596,2304,2292,4512,42,013,100900
42,101100,0000000982764,00001671,739,739,0,739,703,36,1671,1671,0,0,1671,1660,1617,36,1,5,0,1,11,11,0,0,0,0,1671,5,1666,1671,775,896,1617,42,013,101100
42,101200,0000003260604,00003917,1854,1854,0,1854,1777,77,3917,3917,0,0,3917,3908,3838,41,0,19,0,10,9,9,0,0,0,0,3917,24,3893,3917,1788,2129,3838,42,013,101200
42,101400,0000001450604,00004055,1801,1801,0,1801,1647,154,4055,4055,0,0,4055,4013,3872,101,8,14,4,14,42,36,6,0,0,0,4055,51,4004,4055,1946,2109,3872,42,013,101400
42,101500,0000002745678,00003731,1597,1597,0,1597,1532,65,3731,3731,0,0,3731,3721,3694,11,0,15,0,1,10,10,0,0,0,0,3731,11,3720,3731,1716,2015,3694,42,013,101500
42,101600,0000001182330,00003562,1665,1665,0,1665,1490,175,3562,3562,0,0,3562,3534,3409,111,5,8,1,0,28,26,2,0,0,0,3562,32,3530,3562,1668,1894,3409,42,013,101600
42,101700,0000001204284,00004019,1787,1787,0,1787,1638,149,4019,4019,0,0,4019,3985,3881,76,3,14,0,11,34,31,3,0,0,0,4019,37,3982,4019,1918,2101,3881,42,013,101700
42,101800,0000002011237,00003123,1291,1291,0,1291,1207,84,3123,3123,0,0,3123,3113,3080,15,3,8,0,7,10,10,0,0,0,0,3123,5,3118,3123,1404,1719,3080,42,013,101800
42,101900,0000000581453,00001739,1290,1290,0,1290,1088,202,1739,1739,0,0,1739,1728,1570,141,5,1,0,11,11,11,0,0,0,0,1739,24,1715,1739,718,1021,1570,42,013,101900
42,980100,0000366114833,00004187,1997,1997,0,1997,1521,476,4187,4187,0,0,4187,4162,4121,14,12,8,0,7,25,24,1,0,0,0,4187,38,4149,4187,2103,2084,4121,42,015,980100
42,980200,0000332529168,00005177,2256,2256,0,2256,1959,297,5177,5177,0,0,5177,5134,5087,10,26,7,2,2,43,42,1,0,0,0,5177,18,5159,5177,2619,2558,5087,42,015,980200
42,980300,0000005251653,00005813,2722,2722,0,2722,2529,193,5813,5813,0,0,5813,5762,5634,36,10,73,0,9,51,48,3,0,0,0,5813,41,5772,5813,2683,3130,5634,42,015,980300
42,980400,0000004571264,00003415,1500,1500,0,1500,1427,73,3415,3415,0,0,3415,3395,3341,31,5,10,0,8,20,19,1,0,0,0,3415,34,3381,3415,1512,1903,3341,42,015,980400
42,980500,0000115650782,00006045,2620,2620,0,2620,2412,208,6045,6045,0,0,6045,6007,5860,25,17,89,0,16,38,36,2,0,0,0,6045,35,6010,6045,2897,3148,5860,42,015,980500
42,980600,0000259668787,00004521,2051,2051,0,2051,1705,346,4521,4521,0,0,4521,4499,4463,18,9,5,0,4,22,22,0,0,0,0,4521,25,4496,4521,2256,2265,4463,42,015,980600
42,980700,0000252472718,00004681,2033,2033,0,2033,1798,235,4681,4681,0,0,4681,4669,4623,8,8,14,1,15,12,12,0,0,0,0,4681,21,4660,4681,2172,2509,4623,42,015,980700
42,980800,0000265344884,00004045,1779,1779,0,1779,1503,276,4045,4045,0,0,4045,4023,3980,22,14,4,0,3,22,19,3,0,0,0,4045,22,4023,4045,2004,2041,3980,42,015,980800
42,980900,0000227852594,00005514,2465,2465,0,2465,2171,294,5514,5514,0,0,5514,5480,5403,11,28,22,0,16,34,28,5,1,0,0,5514,41,5473,5514,2727,2787,5403,42,015,980900
42,981000,0000002928739,00003024,1459,1459,0,1459,1279,180,3024,3024,0,0,3024,2991,2914,26,11,36,0,4,33,33,0,0,0,0,3024,36,2988,3024,1449,1575,2914,42,015,981000
42,981100,0000150653969,00002977,1326,1326,0,1326,1160,166,2977,2977,0,0,2977,2942,2918,5,10,4,0,5,35,31,4,0,0,0,2977,24,2953,2977,1432,1545,2918,42,015,981100
42,981200,0000379426229,00005137,2709,2709,0,2709,1989,720,5137,5137,0,0,5137,5091,5026,9,30,7,1,18,46,46,0,0,0,0,5137,32,5105,5137,2633,2504,5026,42,015,981200
42,981300,0000517507963,00004148,1990,1990,0,1990,1401,589,4148,4148,0,0,4148,4122,4093,12,9,3,0,5,26,26,0,0,0,0,4148,14,4134,4148,2113,2035,4093,42,015,981300
42,981400,0000100236580,00004077,1757,1757,0,1757,1599,158,4077,4077,0,0,4077,4048,4008,24,4,3,0,9,29,29,0,0,0,0,4077,17,4060,4077,1993,2084,4008,42,015,981400
42,100102,0000007415247,00002771,1391,1391,0,1391,1345,46,2771,2771,0,0,2771,2736,2453,96,6,160,2,19,35,29,6,0,0,0,2771,54,2717,2771,1406,1365,2453,42,017,100102
42,100103,0000001721885,00002420,1085,1085,0,1085,1035,50,2420,2420,0,0,2420,2386,2119,203,11,19,1,33,34,29,5,0,0,0,2420,96,2324,2420,1228,1192,2119,42,017,100103
42,100104,0000002008699,00004475,1810,1810,0,1810,1785,25,4475,4475,0,0,4475,4329,2928,412,19,905,4,61,146,145,1,0,0,0,4475,213,4262,4475,2131,2344,2928,42,017,100104
42,100105,0000002647110,00003406,1239,1239,0,1239,1193,46,3406,3406,0,0,3406,3392,3297,47,4,37,1,6,14,13,1,0,0,0,3406,52,3354,3406,1672,1734,3297,42,017,100105
42,100201,0000006647276,00004322,1707,1707,0,1707,1625,82,4322,4322,0,0,4322,4276,3378,777,11,78,1,31,46,44,2,0,0,0,4322,75,4247,4322,2139,2183,3378,42,017,100201
42,100206,0000004708235,00004447,1818,1818,0,1818,1780,38,4447,4447,0,0,4447,4373,3844,202,3,297,3,24,74,68,5,0,1,0,4447,114,4333,4447,2157,2290,3844,42,017,100206
42,100207,0000005266832,00003842,1507,1507,0,1507,1468,39,3842,3842,0,0,3842,3771,3166,298,7,244,0,56,71,71,0,0,0,0,3842,136,3706,3842,1862,1980,3166,42,017,100207
42,100208,0000004100529,00006441,2648,2648,0,2648,2528,120,6441,6441,0,0,6441,6250,4573,648,12,444,12,561,191,181,7,2,0,1,6441,1159,5282,6441,3485,2956,4573,42,017,100208
42,100209,0000004815122,00007958,3463,3463,0,3463,3255,208,7958,7958,0,0,7958,7802,6205,706,25,795,1,70,156,143,13,0,0,0,7958,261,7697,7958,3966,3992,6205,42,017,100209
42,100210,0000006665663,00007418,2563,2563,0,2563,2507,56,7418,7418,0,0,7418,7330,6648,266,7,377,0,32,88,86,1,0,1,0,7418,128,7290,7418,3684,3734,6648,42,017,100210
42,100211,0000003040342,00006538,2867,2867,0,2867,2685,182,6538,6538,0,0,6538,6451,5826,255,12,302,1,55,87,87,0,0,0,0,6538,136,6402,6538,3138,3400,5826,42,017,100211
42,100212,0000002674278,00004396,1437,1437,0,1437,1421,16,4396,4396,0,0,4396,4371,4006,137,9,202,4,13,25,25,0,0,0,0,4396,81,4315,4396,2200,2196,4006,42,017,100212
42,100302,0000007070724,00005118,1901,1901,0,1901,1811,90,5118,5118,0,0,5118,5085,4954,37,24,26,1,43,33,32,1,0,0,0,5118,112,5006,5118,2641,2477,4954,42,017,100302
42,100303,0000006252527,00005215,1870,1870,0,1870,1794,76,5215,5215,0,0,5215,5073,3242,1581,9,55,0,186,142,131,10,1,0,0,5215,419,4796,5215,2473,2742,3242,42,017,100303
42,100304,0000004093724,00002431,1094,1094,0,1094,1059,35,2431,2431,0,0,2431,2382,1822,422,2,59,3,74,49,43,1,5,0,0,2431,168,2263,2431,1317,1114,1822,42,017,100304
42,100306,0000001669606,00003614,1282,1282,0,1282,1265,17,3614,3614,0,0,3614,3526,2536,340,12,532,1,105,88,88,0,0,0,0,3614,208,3406,3614,1822,1792,2536,42,017,100306
42,100307,0000002437366,00005025,2032,2032,0,2032,1981,51,5025,5025,0,0,5025,4953,4513,253,9,103,0,75,72,67,5,0,0,0,5025,261,4764,5025,2519,2506,4513,42,017,100307
42,100401,0000003234478,00006599,2411,2411,0,2411,2305,106,6599,6599,0,0,6599,6479,5861,371,18,112,1,116,120,112,8,0,0,0,6599,253,6346,6599,3205,3394,5861,42,017,100401
42,100402,0000003389531,00006575,2382,2382,0,2382,2345,37,6575,6575,0,0,6575,6500,6173,212,8,44,3,60,75,73,2,0,0,0,6575,194,6381,6575,3234,3341,6173,42,017,100402
42,100403,0000004183821,00002227,828,828,0,828,803,25,2227,2227,0,0,2227,2208,1233,944,2,4,0,25,19,15,4,0,0,0,2227,47,2180,2227,1045,1182,1233,42,017,100403
42,100404,0000002963648,00006307,2394,2394,0,2394,2234,160,6307,6307,0,0,6307,6220,5834,237,6,47,11,85,87,80,7,0,0,0,6307,178,6129,6307,3079,3228,5834,42,017,100404
42,100406,0000002804316,00004004,1487,1487,0,1487,1369,118,4004,4004,0,0,4004,3954,3574,182,5,159,0,34,50,39,11,0,0,0,4004,124,3880,4004,1930,2074,3574,42,017,100406
42,100407,0000000661410,00001387,483,483,0,483,476,7,1387,1387,0,0,1387,1378,1339,21,0,5,0,13,9,9,0,0,0,0,1387,23,1364,1387,685,702,1339,42,017,100407
42,100408,0000003048080,00007019,2322,2322,0,2322,2291,31,7019,7019,0,0,7019,6937,6737,90,20,42,1,47,82,81,1,0,0,0,7019,152,6867,7019,3479,3540,6737,42,017,100408
42,100500,0000001479402,00002631,1123,1123,0,1123,1087,36,2631,2631,0,0,2631,2594,2503,28,6,6,0,51,37,37,0,0,0,0,2631,115,2516,2631,1306,1325,2503,42,017,100500
42,100600,0000000886440,00003949,1892,1892,0,1892,1775,117,3949,3949,0,0,3949,3850,3371,284,4,17,2,172,99,94,5,0,0,0,3949,467,3482,3949,1849,2100,3371,42,017,100600
42,100700,0000001905796,00003343,1192,1192,0,1192,1142,50,3343,3343,0,0,3343,3209,2408,560,5,11,1,224,134,130,4,0,0,0,3343,562,2781,3343,1563,1780,2408,42,017,100700
42,100803,0000003092786,00004865,1735,1735,0,1735,1712,23,4865,4865,0,0,4865,4806,4589,79,15,87,0,36,59,58,1,0,0,0,4865,90,4775,4865,2417,2448,4589,42,017,100803
42,100804,0000002574884,00003773,1189,1189,0,1189,1174,15,3773,3773,0,0,3773,3746,3631,54,4,39,0,18,27,26,1,0,0,0,3773,46,3727,3773,1882,1891,3631,42,017,100804
42,100805,0000003875864,00006281,2185,2185,0,2185,2158,27,6281,6281,0,0,6281,6238,6059,71,12,68,0,28,43,43,0,0,0,0,6281,83,6198,6281,3038,3243,6059,42,017,100805
42,100807,0000008716835,00003169,1152,1152,0,1152,1055,97,3169,3169,0,0,3169,3150,3002,44,3,80,1,20,19,19,0,0,0,0,3169,36,3133,3169,1387,1782,3002,42,017,100807
42,100808,0000009315838,00005342,1878,1878,0,1878,1857,21,5342,5342,0,0,5342,5314,5125,38,2,129,0,20,28,27,1,0,0,0,5342,61,5281,5342,2546,2796,5125,42,017,100808
42,100809,0000007876689,00004944,1438,1438,0,1438,1431,7,4944,4944,0,0,4944,4900,4634,82,0,173,1,10,44,42,2,0,0,0,4944,64,4880,4944,2488,2456,4634,42,017,100809
42,100810,0000002601154,00003473,1349,1349,0,1349,1290,59,3473,3473,0,0,3473,3453,3245,88,8,101,0,11,20,20,0,0,0,0,3473,47,3426,3473,1672,1801,3245,42,017,100810
42,100811,0000001924485,00004461,2053,2053,0,2053,1976,77,4461,4461,0,0,4461,4364,3662,361,15,258,0,68,97,94,3,0,0,0,4461,205,4256,4461,2146,2315,3662,42,017,100811
42,100900,0000009523870,00007833,2734,2734,0,2734,2668,66,7833,7833,0,0,7833,7759,7485,110,6,126,0,32,74,64,10,0,0,0,7833,125,7708,7833,3922,3911,7485,42,017,100900
42,101000,0000000997216,00000893,356,356,0,356,339,17,893,893,0,0,893,887,870,3,4,9,0,1,6,6,0,0,0,0,893,4,889,893,445,448,870,42,017,101000
42,101100,0000001131052,00002420,927,927,0,927,900,27,2420,2420,0,0,2420,2398,2226,73,3,79,2,15,22,20,0,2,0,0,2420,47,2373,2420,1149,1271,2226,42,017,101100
42,101200,0000001539348,00000927,336,336,0,336,330,6,927,927,0,0,927,922,874,30,1,13,0,4,5,5,0,0,0,0,927,10,917,927,451,476,874,42,017,101200
42,101300,0000001277471,00001981,649,649,0,649,552,97,1981,1981,0,0,1981,1963,1615,301,3,29,0,15,18,17,0,1,0,0,1981,52,1929,1981,1070,911,1615,42,017,101300
42,101401,0000005925469,00003987,1513,1513,0,1513,1498,15,3987,3987,0,0,3987,3952,3880,10,6,44,0,12,35,35,0,0,0,0,3987,40,3947,3987,1963,2024,3880,42,017,101401
42,101403,0000004718493,00006315,2288,2288,0,2288,2227,61,6315,6315,0,0,6315,6287,6170,35,2,56,0,24,28,25,3,0,0,0,6315,46,6269,6315,3097,3218,6170,42,017,101403
42,101404,0000003202132,00002449,882,882,0,882,849,33,2449,2449,0,0,2449,2437,2362,23,1,34,0,17,12,12,0,0,0,0,2449,37,2412,2449,1175,1274,2362,42,017,101404
42,101405,0000003442339,00006525,2650,2650,0,2650,2578,72,6525,6525,0,0,6525,6460,6159,139,3,130,2,27,65,61,4,0,0,0,6525,149,6376,6525,3274,3251,6159,42,017,101405
42,101503,0000005162672,00003964,1559,1559,0,1559,1546,13,3964,3964,0,0,3964,3938,3818,28,3,83,0,6,26,17,9,0,0,0,3964,41,3923,3964,1920,2044,3818,42,017,101503
42,101504,0000002553347,00002977,1313,1313,0,1313,1279,34,2977,2977,0,0,2977,2965,2905,14,0,43,1,2,12,8,4,0,0,0,2977,15,2962,2977,1301,1676,2905,42,017,101504
42,101505,0000004739865,00003411,1166,1166,0,1166,1158,8,3411,3411,0,0,3411,3378,3286,31,1,54,0,6,33,33,0,0,0,0,3411,21,3390,3411,1697,1714,3286,42,017,101505
42,101506,0000004666675,00005412,2085,2085,0,2085,2048,37,5412,5412,0,0,5412,5391,5261,49,6,57,2,16,21,21,0,0,0,0,5412,50,5362,5412,2673,2739,5261,42,017,101506
42,101603,0000002011111,00003075,1222,1222,0,1222,1186,36,3075,3075,0,0,3075,3037,2927,28,0,39,3,40,38,32,6,0,0,0,3075,80,2995,3075,1515,1560,2927,42,017,101603
42,101605,0000002133113,00004196,1649,1649,0,1649,1525,124,4196,4196,0,0,4196,4005,2744,548,18,166,1,528,191,183,7,1,0,0,4196,1007,3189,4196,2063,2133,2744,42,017,101605
42,101607,0000002663614,00003160,1391,1391,0,1391,1352,39,3160,3160,0,0,3160,3140,3062,31,2,33,0,12,20,19,1,0,0,0,3160,37,3123,3160,1450,1710,3062,42,017,101607
42,101608,0000005420486,00004632,1564,1564,0,1564,1546,18,4632,4632,0,0,4632,4553,4161,216,4,130,4,38,79,68,11,0,0,0,4632,105,4527,4632,2320,2312,4161,42,017,101608
42,101609,0000004482068,00004753,1736,1736,0,1736,1721,15,4753,4753,0,0,4753,4734,4581,48,4,74,2,25,19,18,1,0,0,0,4753,61,4692,4753,2334,2419,4581,42,017,101609
42,101610,0000004782973,00004903,1790,1790,0,1790,1744,46,4903,4903,0,0,4903,4879,4687,83,2,77,5,25,24,21,3,0,0,0,4903,67,4836,4903,2400,2503,4687,42,017,101610
42,101611,0000005060424,00006664,2292,2292,0,2292,2276,16,6664,6664,0,0,6664,6622,6396,84,5,105,5,27,42,40,2,0,0,0,6664,97,6567,6664,3265,3399,6396,42,017,101611
42,101700,0000000796291,00000492,199,199,0,199,194,5,492,492,0,0,492,490,470,0,5,14,0,1,2,1,1,0,0,0,492,9,483,492,234,258,470,42,017,101700
42,101802,0000012969514,00004128,1394,1394,0,1394,1315,79,4128,4128,0,0,4128,4104,3891,54,1,134,6,18,24,21,3,0,0,0,4128,36,4092,4128,2109,2019,3891,42,017,101802
42,101803,0000014590723,00004941,1720,1720,0,1720,1686,34,4941,4941,0,0,4941,4910,4721,86,2,84,1,16,31,30,1,0,0,0,4941,61,4880,4941,2494,2447,4721,42,017,101803
42,101804,0000008101093,00008511,3200,3200,0,3200,3123,77,8511,8511,0,0,8511,8435,7941,199,9,221,6,59,76,69,3,4,0,0,8511,178,8333,8511,4196,4315,7941,42,017,101804
42,101900,0000004269566,00003900,1404,1404,0,1404,1382,22,3900,3900,0,0,3900,3870,3766,41,3,58,0,2,30,29,1,0,0,0,3900,45,3855,3900,1919,1981,3766,42,017,101900
42,102002,0000020276747,00002834,962,962,0,962,936,26,2834,2834,0,0,2834,2822,2718,50,8,37,0,9,12,11,1,0,0,0,2834,33,2801,2834,1396,1438,2718,42,017,102002
42,102003,0000012494456,00003782,1301,1301,0,1301,1284,17,3782,3782,0,0,3782,3753,3652,43,4,46,0,8,29,26,0,3,0,0,3782,53,3729,3782,1899,1883,3652,42,017,102003
42,102004,0000005307853,00004082,1706,1706,0,1706,1675,31,4082,4082,0,0,4082,4048,3928,51,1,39,0,29,34,34,0,0,0,0,4082,51,4031,4082,1926,2156,3928,42,017,102004
42,102102,0000027694985,00003130,1112,1112,0,1112,1092,20,3130,3130,0,0,3130,3108,3066,19,5,15,2,1,22,21,1,0,0,0,3130,18,3112,3130,1564,1566,3066,42,017,102102
42,102103,0000020441073,00003973,1345,1345,0,1345,1327,18,3973,3973,0,0,3973,3952,3891,32,1,28,0,0,21,17,4,0,0,0,3973,26,3947,3973,1958,2015,3891,42,017,102103
42,102104,0000021563288,00004999,1913,1913,0,1913,1856,57,4999,4999,0,0,4999,4922,4654,135,5,88,1,39,77,56,20,1,0,0,4999,133,4866,4999,2451,2548,4654,42,017,102104
42,102200,0000001167819,00001001,329,329,0,329,323,6,1001,1001,0,0,1001,998,991,2,1,1,0,3,3,3,0,0,0,0,1001,8,993,1001,528,473,991,42,017,102200
42,102300,0000033538435,00005199,1883,1883,0,1883,1828,55,5199,5199,0,0,5199,5149,5053,42,21,20,3,10,50,48,2,0,0,0,5199,65,5134,5199,2626,2573,5053,42,017,102300
42,102400,0000006707214,00008828,3378,3378,0,3378,3294,84,8828,8828,0,0,8828,8776,8631,52,14,47,0,32,52,46,6,0,0,0,8828,120,8708,8828,4385,4443,8631,42,017,102400
42,102500,0000003004705,00004564,1827,1827,0,1827,1770,57,4564,4564,0,0,4564,4514,4441,26,7,16,2,22,50,47,3,0,0,0,4564,91,4473,4564,2295,2269,4441,42,017,102500
42,102600,0000001372929,00002211,1015,1015,0,1015,988,27,2211,2211,0,0,2211,2199,2092,34,1,52,0,20,12,12,0,0,0,0,2211,72,2139,2211,957,1254,2092,42,017,102600
42,102700,0000042212928,00004233,1701,1701,0,1701,1636,65,4233,4233,0,0,4233,4213,4158,23,6,20,0,6,20,20,0,0,0,0,4233,25,4208,4233,2051,2182,4158,42,017,102700
42,102801,0000028270451,00003096,1093,1093,0,1093,1057,36,3096,3096,0,0,3096,3082,3018,21,2,25,1,15,14,12,2,0,0,0,3096,19,3077,3096,1602,1494,3018,42,017,102801
42,102802,0000044399425,00005714,2068,2068,0,2068,2016,52,5714,5714,0,0,5714,5685,5594,40,6,32,0,13,29,28,1,0,0,0,5714,71,5643,5714,2782,2932,5594,42,017,102802
42,102900,0000001108121,00001059,382,382,0,382,374,8,1059,1059,0,0,1059,1055,1037,6,0,7,0,5,4,4,0,0,0,0,1059,9,1050,1059,521,538,1037,42,017,102900
42,103001,0000020671385,00004694,1881,1881,0,1881,1819,62,4694,4694,0,0,4694,4636,4488,52,7,66,0,23,58,56,2,0,0,0,4694,68,4626,4694,2322,2372,4488,42,017,103001
42,103002,0000032323072,00005226,1996,1996,0,1996,1944,52,5226,5226,0,0,5226,5178,5070,40,4,49,0,15,48,47,1,0,0,0,5226,63,5163,5226,2584,2642,5070,42,017,103002
42,103101,0000001132052,00002478,987,987,0,987,949,38,2478,2478,0,0,2478,2459,2395,30,2,19,0,13,19,19,0,0,0,0,2478,38,2440,2478,1250,1228,2395,42,017,103101
42,103102,0000001544839,00002080,879,879,0,879,842,37,2080,2080,0,0,2080,2055,1939,27,4,27,4,54,25,24,1,0,0,0,2080,84,1996,2080,1044,1036,1939,42,017,103102
42,103103,0000002560511,00004373,1765,1765,0,1765,1630,135,4373,4373,0,0,4373,4322,4102,50,6,89,1,74,51,48,3,0,0,0,4373,135,4238,4373,2077,2296,4102,42,017,103103
42,103200,0000000660073,00001283,451,451,0,451,430,21,1283,1283,0,0,1283,1277,1261,5,0,6,0,5,6,6,0,0,0,0,1283,16,1267,1283,597,686,1261,42,017,103200
42,103300,0000051989416,00002191,841,841,0,841,805,36,2191,2191,0,0,2191,2184,2147,8,2,20,5,2,7,6,1,0,0,0,2191,6,2185,2191,1130,1061,2147,42,017,103300
42,103400,0000079721587,00004963,1972,1972,0,1972,1900,72,4963,4963,0,0,4963,4943,4894,30,5,5,0,9,20,20,0,0,0,0,4963,43,4920,4963,2485,2478,4894,42,017,103400
42,103500,0000023843718,00001313,525,525,0,525,485,40,1313,1313,0,0,1313,1303,1289,1,0,10,0,3,10,8,2,0,0,0,1313,14,1299,1313,701,612,1289,42,017,103500
42,103600,0000002575532,00000863,403,403,0,403,378,25,863,863,0,0,863,862,856,1,0,2,0,3,1,1,0,0,0,0,863,5,858,863,432,431,856,42,017,103600
42,103700,0000057477511,00003517,1411,1411,0,1411,1337,74,3517,3517,0,0,3517,3489,3457,18,1,4,4,5,28,24,4,0,0,0,3517,21,3496,3517,1808,1709,3457,42,017,103700
42,103800,0000016764206,00001408,612,612,0,612,559,53,1408,1408,0,0,1408,1407,1396,6,1,4,0,0,1,1,0,0,0,0,1408,12,1396,1408,702,706,1396,42,017,103800
42,103900,0000078227732,00004206,1834,1834,0,1834,1674,160,4206,4206,0,0,4206,4169,4090,32,7,17,2,21,37,36,1,0,0,0,4206,57,4149,4206,2189,2017,4090,42,017,103900
42,104000,0000078103688,00004804,1868,1868,0,1868,1788,80,4804,4804,0,0,4804,4773,4714,28,1,20,1,9,31,31,0,0,0,0,4804,44,4760,4804,2441,2363,4714,42,017,104000
42,104100,0000001410180,00002083,869,869,0,869,851,18,2083,2083,0,0,2083,2053,1981,31,4,24,3,10,30,29,1,0,0,0,2083,39,2044,2083,1034,1049,1981,42,017,104100
42,104200,0000070346273,00011409,4103,4103,0,4103,3938,165,11409,11409,0,0,11409,11320,10994,81,32,115,1,97,89,87,0,2,0,0,11409,226,11183,11409,5732,5677,10994,42,017,104200
42,104300,0000068998036,00007743,3207,3207,0,3207,3053,154,7743,7743,0,0,7743,7684,7520,49,15,66,7,27,59,57,2,0,0,0,7743,112,7631,7743,3858,3885,7520,42,017,104300
42,104400,0000003293594,00002252,1251,1251,0,1251,1160,91,2252,2252,0,0,2252,2229,2138,25,5,19,0,42,23,23,0,0,0,0,2252,125,2127,2252,1205,1047,2138,42,017,104400
42,104501,0000036272470,00012136,4041,4041,0,4041,3937,104,12136,12136,0,0,12136,12055,11685,155,18,163,2,32,81,71,6,0,4,0,12136,184,11952,12136,5990,6146,11685,42,017,104501
42,104502,0000049408527,00004306,1820,1820,0,1820,1774,46,4306,4306,0,0,4306,4282,4222,16,1,32,0,11,24,22,2,0,0,0,4306,36,4270,4306,2017,2289,4222,42,017,104502
42,104601,0000013274956,00004752,1716,1716,0,1716,1694,22,4752,4752,0,0,4752,4726,4626,38,1,60,0,1,26,26,0,0,0,0,4752,41,4711,4752,2333,2419,4626,42,017,104601
42,104603,0000015159743,00006201,1834,1834,0,1834,1785,49,6201,6201,0,0,6201,6164,5685,355,4,94,1,25,37,33,1,3,0,0,6201,119,6082,6201,3254,2947,5685,42,017,104603
42,104604,0000011388240,00006657,2647,2647,0,2647,2517,130,6657,6657,0,0,6657,6607,6457,64,6,67,3,10,50,45,5,0,0,0,6657,87,6570,6657,3068,3589,6457,42,017,104604
42,104701,0000002319431,00003089,1788,1788,0,1788,1755,33,3089,3089,0,0,3089,3066,2939,37,2,73,1,14,23,21,1,1,0,0,3089,33,3056,3089,1258,1831,2939,42,017,104701
42,104702,0000001402872,00002745,1304,1304,0,1304,1254,50,2745,2745,0,0,2745,2734,2651,55,1,13,2,12,11,11,0,0,0,0,2745,39,2706,2745,1270,1475,2651,42,017,104702
42,104703,0000002173527,00002402,966,966,0,966,946,20,2402,2402,0,0,2402,2384,2320,15,6,31,3,9,18,17,1,0,0,0,2402,27,2375,2402,1117,1285,2320,42,017,104703
42,104800,0000003298068,00003125,930,930,0,930,912,18,3125,3125,0,0,3125,3096,2996,64,2,25,1,8,29,29,0,0,0,0,3125,51,3074,3125,1478,1647,2996,42,017,104800
42,104901,0000011025783,00006302,2000,2000,0,2000,1927,73,6302,6302,0,0,6302,6270,6070,53,7,130,1,9,32,31,1,0,0,0,6302,43,6259,6302,3126,3176,6070,42,017,104901
42,104902,0000017822697,00005675,2050,2050,0,2050,2006,44,5675,5675,0,0,5675,5630,5420,71,1,126,5,7,45,45,0,0,0,0,5675,80,5595,5675,2758,2917,5420,42,017,104902
42,105003,0000012535768,00005033,1589,1589,0,1589,1582,7,5033,5033,0,0,5033,5002,4924,13,0,65,0,0,31,31,0,0,0,0,5033,30,5003,5033,2450,2583,4924,42,017,105003
42,105004,0000008802472,00005627,1771,1771,0,1771,1763,8,5627,5627,0,0,5627,5603,5519,18,1,61,0,4,24,22,2,0,0,0,5627,33,5594,5627,2750,2877,5519,42,017,105004
42,105006,0000009386970,00005974,1934,1934,0,1934,1911,23,5974,5974,0,0,5974,5942,5792,15,0,129,3,3,32,32,0,0,0,0,5974,41,5933,5974,2964,3010,5792,42,017,105006
42,105007,0000010315541,00008404,2653,2653,0,2653,2638,15,8404,8404,0,0,8404,8353,8161,39,2,140,0,11,51,46,1,3,1,0,8404,58,8346,8404,4132,4272,8161,42,017,105007
42,105008,0000016407359,00002954,898,898,0,898,888,10,2954,2954,0,0,2954,2951,2889,9,1,49,0,3,3,3,0,0,0,0,2954,28,2926,2954,1463,1491,2889,42,017,105008
42,105009,0000002566487,00003620,1613,1613,0,1613,1576,37,3620,3620,0,0,3620,3588,3504,25,5,34,0,20,32,31,1,0,0,0,3620,39,3581,3620,1616,2004,3504,42,017,105009
42,105010,0000003127076,00003950,1354,1354,0,1354,1341,13,3950,3950,0,0,3950,3927,3792,14,1,114,0,6,23,23,0,0,0,0,3950,47,3903,3950,1908,2042,3792,42,017,105010
42,105011,0000003760865,00003822,1326,1326,0,1326,1315,11,3822,3822,0,0,3822,3791,3624,30,4,116,0,17,31,26,5,0,0,0,3822,49,3773,3822,1849,1973,3624,42,017,105011
42,105100,0000025711553,00002839,986,986,0,986,971,15,2839,2839,0,0,2839,2822,2752,24,1,43,0,2,17,16,1,0,0,0,2839,17,2822,2839,1398,1441,2752,42,017,105100
42,105202,0000006336584,00005312,2226,2226,0,2226,2205,21,5312,5312,0,0,5312,5255,4982,48,0,212,0,13,57,55,2,0,0,0,5312,65,5247,5312,2497,2815,4982,42,017,105202
42,105203,0000008483086,00002063,704,704,0,704,696,8,2063,2063,0,0,2063,2049,1948,47,1,53,0,0,14,13,1,0,0,0,2063,29,2034,2063,1024,1039,1948,42,017,105203
42,105204,0000016149832,00010831,3918,3918,0,3918,3860,58,10831,10831,0,0,10831,10726,10122,96,6,469,0,33,105,91,11,1,2,0,10831,148,10683,10831,5260,5571,10122,42,017,105204
42,105300,0000001425191,00002312,936,936,0,936,920,16,2312,2312,0,0,2312,2290,2241,26,2,17,0,4,22,20,2,0,0,0,2312,22,2290,2312,1043,1269,2241,42,017,105300
42,105400,0000054207455,00007180,2598,2598,0,2598,2512,86,7180,7180,0,0,7180,7144,6973,58,5,91,0,17,36,34,2,0,0,0,7180,81,7099,7180,3529,3651,6973,42,017,105400
42,105501,0000020625318,00008153,2520,2520,0,2520,2462,58,8153,8153,0,0,8153,8063,7525,121,3,390,0,24,90,83,3,0,4,0,8153,122,8031,8153,4039,4114,7525,42,017,105501
42,105503,0000007500802,00009146,4085,4085,0,4085,3989,96,9146,9146,0,0,9146,9088,8423,258,12,366,0,29,58,53,5,0,0,0,9146,167,8979,9146,4360,4786,8423,42,017,105503
42,105505,0000005265749,00003934,1512,1512,0,1512,1478,34,3934,3934,0,0,3934,3908,3805,35,1,54,1,12,26,25,1,0,0,0,3934,33,3901,3934,1921,2013,3805,42,017,105505
42,105506,0000005702908,00004110,1260,1260,0,1260,1252,8,4110,4110,0,0,4110,4083,3765,88,8,204,0,18,27,27,0,0,0,0,4110,59,4051,4110,2008,2102,3765,42,017,105506
42,105507,0000007366602,00007338,2554,2554,0,2554,2525,29,7338,7338,0,0,7338,7285,6980,90,0,203,0,12,53,46,7,0,0,0,7338,82,7256,7338,3610,3728,6980,42,017,105507
42,105600,0000002370773,00002498,1209,1209,0,1209,1170,39,2498,2498,0,0,2498,2471,2339,86,2,30,1,13,27,25,1,1,0,0,2498,44,2454,2498,1188,1310,2339,42,017,105600
42,105702,0000002295716,00003326,1487,1487,0,1487,1409,78,3326,3326,0,0,3326,3266,2975,216,11,16,0,48,60,51,9,0,0,0,3326,122,3204,3326,1664,1662,2975,42,017,105702
42,105704,0000002291607,00006697,2826,2826,0,2826,2745,81,6697,6697,0,0,6697,6613,4640,1702,7,104,0,160,84,77,6,1,0,0,6697,361,6336,6697,3128,3569,4640,42,017,105704
42,105801,0000009507201,00006807,2575,2575,0,2575,2527,48,6807,6807,0,0,6807,6700,5226,1003,7,367,0,97,107,96,11,0,0,0,6807,263,6544,6807,3349,3458,5226,42,017,105801
42,105805,0000010306750,00005808,2610,2610,0,2610,2446,164,5808,5808,0,0,5808,5721,5306,197,15,158,1,44,87,78,9,0,0,0,5808,126,5682,5808,2828,2980,5306,42,017,105805
42,105806,0000026419373,00000103,45,45,0,45,38,7,103,103,0,0,103,103,102,0,0,1,0,0,0,0,0,0,0,0,103,1,102,103,54,49,102,42,017,105806
42,105807,0000001608348,00003506,1533,1533,0,1533,1494,39,3506,3506,0,0,3506,3425,3003,232,13,149,0,28,81,74,7,0,0,0,3506,102,3404,3506,1637,1869,3003,42,017,105807
42,105808,0000002384905,00003643,1437,1437,0,1437,1392,45,3643,3643,0,0,3643,3608,3497,25,5,57,0,24,35,35,0,0,0,0,3643,83,3560,3643,1757,1886,3497,42,017,105808
42,105809,0000003129303,00004480,1584,1584,0,1584,1567,17,4480,4480,0,0,4480,4429,4245,57,5,95,0,27,51,50,1,0,0,0,4480,96,4384,4480,2195,2285,4245,42,017,105809
42,105810,0000001261029,00002668,1003,1003,0,1003,995,8,2668,2668,0,0,2668,2637,2531,60,0,16,0,30,31,27,4,0,0,0,2668,51,2617,2668,1302,1366,2531,42,017,105810
42,105811,0000002253914,00006132,2150,2150,0,2150,2125,25,6132,6132,0,0,6132,6065,5863,127,9,52,6,8,67,64,1,2,0,0,6132,77,6055,6132,3020,3112,5863,42,017,105811
42,105812,0000000829733,00001718,591,591,0,591,586,5,1718,1718,0,0,1718,1700,1681,3,1,4,0,11,18,17,1,0,0,0,1718,19,1699,1718,833,885,1681,42,017,105812
42,105900,0000004080345,00002031,819,819,0,819,803,16,2031,2031,0,0,2031,2028,1985,30,1,10,0,2,3,3,0,0,0,0,2031,28,2003,2031,978,1053,1985,42,017,105900
42,902100,0000001039451,00002473,1267,1267,0,1267,1175,92,2473,2473,0,0,2473,2450,2406,26,3,10,1,4,23,20,3,0,0,0,2473,23,2450,2473,1134,1339,2406,42,019,902100
42,902200,0000001447497,00002069,1059,1059,0,1059,937,122,2069,2069,0,0,2069,2061,2033,23,2,3,0,0,8,8,0,0,0,0,2069,21,2048,2069,954,1115,2033,42,019,902200
42,902300,0000001777989,00003764,1698,1698,0,1698,1556,142,3764,3764,0,0,3764,3711,3517,126,5,22,0,41,53,48,5,0,0,0,3764,85,3679,3764,1831,1933,3517,42,019,902300
42,902400,0000001043852,00002698,1413,1413,0,1413,1279,134,2698,2698,0,0,2698,2669,2568,76,7,10,0,8,29,29,0,0,0,0,2698,40,2658,2698,1248,1450,2568,42,019,902400
42,902500,0000001670552,00004117,1965,1965,0,1965,1793,172,4117,4117,0,0,4117,4058,3920,84,4,21,3,26,59,56,3,0,0,0,4117,46,4071,4117,1916,2201,3920,42,019,902500
42,902600,0000005093356,00003229,1269,1269,0,1269,1232,37,3229,3229,0,0,3229,3213,3181,23,3,6,0,0,16,16,0,0,0,0,3229,4,3225,3229,1532,1697,3181,42,019,902600
42,902700,0000002987801,00002076,1033,1033,0,1033,960,73,2076,2076,0,0,2076,2055,2039,9,2,2,0,3,21,19,2,0,0,0,2076,13,2063,2076,1025,1051,2039,42,019,902700
42,902800,0000006487521,00002911,1476,1476,0,1476,1405,71,2911,2911,0,0,2911,2893,2835,25,0,32,0,1,18,17,1,0,0,0,2911,4,2907,2911,1378,1533,2835,42,019,902800
42,902900,0000008214973,00001675,728,728,0,728,694,34,1675,1675,0,0,1675,1671,1642,9,0,12,3,5,4,4,0,0,0,0,1675,11,1664,1675,807,868,1642,42,019,902900
42,903000,0000020702895,00004660,1905,1905,0,1905,1850,55,4660,4660,0,0,4660,4648,4614,14,3,12,4,1,12,12,0,0,0,0,4660,18,4642,4660,2291,2369,4614,42,019,903000
42,903100,0000012202315,00002634,1089,1089,0,1089,1060,29,2634,2634,0,0,2634,2624,2593,12,1,14,2,2,10,10,0,0,0,0,2634,17,2617,2634,1261,1373,2593,42,019,903100
42,910100,0000192873481,00004532,1947,1947,0,1947,1683,264,4532,4532,0,0,4532,4516,4486,15,3,4,6,2,16,15,0,0,1,0,4532,12,4520,4532,2240,2292,4486,42,019,910100
42,910200,0000262490861,00004961,2044,2044,0,2044,1829,215,4961,4961,0,0,4961,4945,4898,15,14,8,8,2,16,13,3,0,0,0,4961,22,4939,4961,2522,2439,4898,42,019,910200
42,910300,0000217285256,00008578,3567,3567,0,3567,3224,343,8578,8578,0,0,8578,8519,8429,43,6,26,0,15,59,53,6,0,0,0,8578,41,8537,8578,4251,4327,8429,42,019,910300
42,910400,0000004145137,00002706,993,993,0,993,935,58,2706,2706,0,0,2706,2671,2460,92,5,94,2,18,35,34,1,0,0,0,2706,29,2677,2706,1274,1432,2460,42,019,910400
42,910500,0000001628683,00002209,64,64,0,64,59,5,2209,2209,0,0,2209,2190,2037,97,1,47,0,8,19,17,2,0,0,0,2209,24,2185,2209,932,1277,2037,42,019,910500
42,910600,0000129877489,00004225,1685,1685,0,1685,1591,94,4225,4225,0,0,4225,4205,4191,7,0,3,0,4,20,16,3,1,0,0,4225,23,4202,4225,2111,2114,4191,42,019,910600
42,910700,0000059382333,00003074,1168,1168,0,1168,1112,56,3074,3074,0,0,3074,3071,3060,3,5,3,0,0,3,3,0,0,0,0,3074,2,3072,3074,1561,1513,3060,42,019,910700
42,910800,0000045929533,00003357,1389,1389,0,1389,1336,53,3357,3357,0,0,3357,3345,3303,17,2,15,0,8,12,12,0,0,0,0,3357,7,3350,3357,1703,1654,3303,42,019,910800
42,910900,0000017390818,00004825,2093,2093,0,2093,1997,96,4825,4825,0,0,4825,4802,4737,19,1,32,1,12,23,23,0,0,0,0,4825,21,4804,4825,2241,2584,4737,42,019,910900
42,911000,0000124792786,00006061,2480,2480,0,2480,2395,85,6061,6061,0,0,6061,6030,5994,6,9,10,6,5,31,31,0,0,0,0,6061,23,6038,6061,3051,3010,5994,42,019,911000
42,911100,0000061859087,00004217,1662,1662,0,1662,1585,77,4217,4217,0,0,4217,4206,4180,5,6,9,1,5,11,11,0,0,0,0,4217,25,4192,4217,2131,2086,4180,42,019,911100
42,911200,0000060445145,00005407,2057,2057,0,2057,1977,80,5407,5407,0,0,5407,5391,5189,188,1,11,1,1,16,16,0,0,0,0,5407,38,5369,5407,2871,2536,5189,42,019,911200
42,911300,0000121475608,00005448,2044,2044,0,2044,1934,110,5448,5448,0,0,5448,5431,5400,13,9,3,0,6,17,15,2,0,0,0,5448,23,5425,5448,2675,2773,5400,42,019,911300
42,911400,0000063241123,00003585,1381,1381,0,1381,1335,46,3585,3585,0,0,3585,3574,3552,6,6,3,1,6,11,11,0,0,0,0,3585,10,3575,3585,1752,1833,3552,42,019,911400
42,911501,0000060568340,00005690,1970,1970,0,1970,1916,54,5690,5690,0,0,5690,5677,5659,9,0,3,0,6,13,13,0,0,0,0,5690,15,5675,5690,2615,3075,5659,42,019,911501
42,911502,0000063964522,00004408,1788,1788,0,1788,1698,90,4408,4408,0,0,4408,4374,4357,8,1,3,0,5,34,30,4,0,0,0,4408,36,4372,4408,2091,2317,4357,42,019,911502
42,911600,0000062539294,00005210,1980,1980,0,1980,1896,84,5210,5210,0,0,5210,5193,5145,13,3,28,2,2,17,17,0,0,0,0,5210,22,5188,5210,2630,2580,5145,42,019,911600
42,911700,0000062525395,00004696,1939,1939,0,1939,1789,150,4696,4696,0,0,4696,4685,4645,8,8,20,1,3,11,11,0,0,0,0,4696,10,4686,4696,2389,2307,4645,42,019,911700
42,911800,0000115350896,00006156,2371,2371,0,2371,2264,107,6156,6156,0,0,6156,6126,6059,39,3,16,1,8,30,29,1,0,0,0,6156,22,6134,6156,3080,3076,6059,42,019,911800
42,911900,0000006492996,00005060,2547,2547,0,2547,2365,182,5060,5060,0,0,5060,5026,4966,21,5,27,0,7,34,34,0,0,0,0,5060,19,5041,5060,2343,2717,4966,42,019,911900
42,912000,0000023369116,00007800,3082,3082,0,3082,2910,172,7800,7800,0,0,7800,7735,7460,76,8,163,1,27,65,60,5,0,0,0,7800,68,7732,7800,3834,3966,7460,42,019,912000
42,912101,0000003335869,00003909,1434,1434,0,1434,1399,35,3909,3909,0,0,3909,3892,3790,48,2,49,1,2,17,15,2,0,0,0,3909,13,3896,3909,1899,2010,3790,42,019,912101
42,912102,0000001915508,00002953,1108,1108,0,1108,1078,30,2953,2953,0,0,2953,2937,2891,16,1,24,0,5,16,16,0,0,0,0,2953,21,2932,2953,1437,1516,2891,42,019,912102
42,912200,0000004255472,00002965,1043,1043,0,1043,1010,33,2965,2965,0,0,2965,2950,2893,25,0,28,0,4,15,15,0,0,0,0,2965,24,2941,2965,1433,1532,2893,42,019,912200
42,912300,0000028321890,00007984,2884,2884,0,2884,2712,172,7984,7984,0,0,7984,7920,7733,57,4,111,3,12,64,61,3,0,0,0,7984,71,7913,7984,3992,3992,7733,42,019,912300
42,912400,0000062138929,00009348,3529,3529,0,3529,3326,203,9348,9348,0,0,9348,9307,9153,64,3,65,5,17,41,40,1,0,0,0,9348,60,9288,9348,4428,4920,9153,42,019,912400
42,912700,0000062548524,00006827,2612,2612,0,2612,2521,91,6827,6827,0,0,6827,6808,6763,16,8,20,0,1,19,16,3,0,0,0,6827,15,6812,6827,3394,3433,6763,42,019,912700
42,912800,0000059480574,00005586,2105,2105,0,2105,2045,60,5586,5586,0,0,5586,5564,5524,14,5,9,1,11,22,22,0,0,0,0,5586,38,5548,5586,2752,2834,5524,42,019,912800
42,000100,0000000549703,00001363,1128,1128,0,1128,941,187,1363,1363,0,0,1363,1351,1234,106,3,2,1,5,12,12,0,0,0,0,1363,26,1337,1363,560,803,1234,42,021,000100
42,000200,0000000989803,00001442,823,823,0,823,616,207,1442,1442,0,0,1442,1403,934,426,3,1,4,35,39,35,4,0,0,0,1442,39,1403,1442,691,751,934,42,021,000200
42,000300,0000000974198,00002273,1170,1170,0,1170,974,196,2273,2273,0,0,2273,2185,1647,510,3,3,1,21,88,79,5,4,0,0,2273,50,2223,2273,1035,1238,1647,42,021,000300
42,000400,0000001266260,00001160,569,569,0,569,503,66,1160,1160,0,0,1160,1134,1063,67,2,1,0,1,26,25,1,0,0,0,1160,11,1149,1160,564,596,1063,42,021,000400
42,000500,0000000893175,00001963,1046,1046,0,1046,922,124,1963,1963,0,0,1963,1930,1842,71,1,2,0,14,33,33,0,0,0,0,1963,37,1926,1963,909,1054,1842,42,021,000500
42,000600,0000000876976,00002310,1149,1149,0,1149,1013,136,2310,2310,0,0,2310,2285,2177,95,5,1,4,3,25,25,0,0,0,0,2310,22,2288,2310,1071,1239,2177,42,021,000600
42,000700,0000002010163,00003028,1546,1546,0,1546,1413,133,3028,3028,0,0,3028,2996,2872,70,3,40,0,11,32,31,1,0,0,0,3028,42,2986,3028,1396,1632,2872,42,021,000700
42,000800,0000000589821,00001067,552,552,0,552,469,83,1067,1067,0,0,1067,1033,895,127,0,1,0,10,34,32,2,0,0,0,1067,14,1053,1067,482,585,895,42,021,000800
42,000900,0000000866420,00000721,368,368,0,368,333,35,721,721,0,0,721,711,674,31,0,1,1,4,10,9,1,0,0,0,721,18,703,721,346,375,674,42,021,000900
42,001000,0000002561330,00001141,580,580,0,580,486,94,1141,1141,0,0,1141,1087,533,540,1,1,0,12,54,51,3,0,0,0,1141,22,1119,1141,518,623,533,42,021,001000
42,001100,0000000583485,00000439,300,300,0,300,248,52,439,439,0,0,439,434,416,16,0,2,0,0,5,5,0,0,0,0,439,5,434,439,211,228,416,42,021,001100
42,001200,0000001093389,00003544,1815,1815,0,1815,1606,209,3544,3544,0,0,3544,3507,3415,74,2,9,0,7,37,35,2,0,0,0,3544,39,3505,3544,1594,1950,3415,42,021,001200
42,001300,0000001248166,00002534,1295,1295,0,1295,1193,102,2534,2534,0,0,2534,2483,2154,306,4,4,0,15,51,44,4,3,0,0,2534,33,2501,2534,1134,1400,2154,42,021,001300
42,001400,0000000609627,00000921,461,461,0,461,417,44,921,921,0,0,921,907,771,122,4,0,1,9,14,14,0,0,0,0,921,22,899,921,428,493,771,42,021,001400
42,010100,0000050877757,00004380,1851,1851,0,1851,1764,87,4380,4380,0,0,4380,4365,4265,92,3,2,0,3,15,14,1,0,0,0,4380,39,4341,4380,2147,2233,4265,42,021,010100
42,010200,0000002162013,00001733,907,907,0,907,792,115,1733,1733,0,0,1733,1723,1638,83,0,0,2,0,10,10,0,0,0,0,1733,16,1717,1733,805,928,1638,42,021,010200
42,010300,0000029983875,00002501,1034,1034,0,1034,995,39,2501,2501,0,0,2501,2494,2469,20,1,4,0,0,7,7,0,0,0,0,2501,15,2486,2501,1212,1289,2469,42,021,010300
42,010400,0000000457107,00001503,745,745,0,745,685,60,1503,1503,0,0,1503,1483,1401,69,4,4,0,5,20,18,2,0,0,0,1503,22,1481,1503,681,822,1401,42,021,010400
42,010500,0000009618698,00003951,1964,1964,0,1964,1832,132,3951,3951,0,0,3951,3934,3883,33,0,11,0,7,17,17,0,0,0,0,3951,26,3925,3951,1849,2102,3883,42,021,010500
42,010600,0000002799171,00002555,1160,1160,0,1160,1105,55,2555,2555,0,0,2555,2543,2496,10,1,35,0,1,12,12,0,0,0,0,2555,8,2547,2555,1189,1366,2496,42,021,010600
42,010700,0000022939324,00003054,1309,1309,0,1309,1249,60,3054,3054,0,0,3054,3046,3020,6,4,16,0,0,8,8,0,0,0,0,3054,13,3041,3054,1480,1574,3020,42,021,010700
42,010801,0000015052010,00005753,2555,2555,0,2555,2442,113,5753,5753,0,0,5753,5723,5575,37,5,97,0,9,30,28,2,0,0,0,5753,32,5721,5753,2638,3115,5575,42,021,010801
42,010802,0000013702881,00003791,1130,1130,0,1130,1050,80,3791,3791,0,0,3791,3773,3641,55,3,67,0,7,18,18,0,0,0,0,3791,20,3771,3791,1693,2098,3641,42,021,010802
42,010900,0000001610566,00000851,375,375,0,375,347,28,851,851,0,0,851,849,847,2,0,0,0,0,2,2,0,0,0,0,851,5,846,851,399,452,847,42,021,010900
42,011000,0000000913792,00001834,849,849,0,849,792,57,1834,1834,0,0,1834,1830,1806,21,2,1,0,0,4,3,1,0,0,0,1834,4,1830,1834,861,973,1806,42,021,011000
42,011100,0000030756842,00005862,2275,2275,0,2275,2156,119,5862,5862,0,0,5862,5848,5764,39,9,29,3,4,14,14,0,0,0,0,5862,22,5840,5862,2738,3124,5764,42,021,011100
42,011200,0000002723517,00002262,1021,1021,0,1021,965,56,2262,2262,0,0,2262,2242,2223,5,1,10,0,3,20,20,0,0,0,0,2262,11,2251,2262,1067,1195,2223,42,021,011200
42,011300,0000006139328,00005523,2376,2376,0,2376,2238,138,5523,5523,0,0,5523,5493,5390,17,5,71,3,7,30,24,6,0,0,0,5523,50,5473,5523,2603,2920,5390,42,021,011300
42,011400,0000034803850,00003912,1880,1880,0,1880,1772,108,3912,3912,0,0,3912,3899,3857,27,0,11,2,2,13,12,1,0,0,0,3912,12,3900,3912,1839,2073,3857,42,021,011400
42,011500,0000125167032,00004925,2025,2025,0,2025,1940,85,4925,4925,0,0,4925,4900,4891,2,1,4,0,2,25,24,1,0,0,0,4925,5,4920,4925,2433,2492,4891,42,021,011500
42,011600,0000004736116,00003054,1362,1362,0,1362,1272,90,3054,3054,0,0,3054,3045,3036,7,1,0,0,1,9,8,1,0,0,0,3054,9,3045,3054,1427,1627,3036,42,021,011600
42,011700,0000081783662,00002728,1128,1128,0,1128,1043,85,2728,2728,0,0,2728,2722,2719,1,0,1,0,1,6,6,0,0,0,0,2728,6,2722,2728,1387,1341,2719,42,021,011700
42,011800,0000153404836,00004373,1701,1701,0,1701,1582,119,4373,4373,0,0,4373,4367,4359,1,5,1,0,1,6,6,0,0,0,0,4373,13,4360,4373,2181,2192,4359,42,021,011800
42,011900,0000007757841,00004199,1954,1954,0,1954,1763,191,4199,4199,0,0,4199,4192,4170,3,4,10,1,4,7,7,0,0,0,0,4199,13,4186,4199,1987,2212,4170,42,021,011900
42,012000,0000193711488,00006437,2751,2751,0,2751,2508,243,6437,6437,0,0,6437,6423,6406,5,4,3,0,5,14,14,0,0,0,0,6437,20,6417,6437,3140,3297,6406,42,021,012000
42,012100,0000153287654,00002577,1216,1216,0,1216,934,282,2577,2577,0,0,2577,2563,2529,10,2,16,2,4,14,14,0,0,0,0,2577,9,2568,2577,1322,1255,2529,42,021,012100
42,012200,0000100381629,00004044,1686,1686,0,1686,1570,116,4044,4044,0,0,4044,4017,4006,2,6,1,1,1,27,27,0,0,0,0,4044,19,4025,4044,1996,2048,4006,42,021,012200
42,012300,0000079721510,00003798,777,777,0,777,716,61,3798,3798,0,0,3798,3776,3301,430,7,33,1,4,22,22,0,0,0,0,3798,273,3525,3798,2259,1539,3301,42,021,012300
42,012400,0000094852026,00004292,1674,1674,0,1674,1573,101,4292,4292,0,0,4292,4277,4269,4,0,2,0,2,15,15,0,0,0,0,4292,2,4290,4292,2141,2151,4269,42,021,012400
42,012500,0000127574248,00006323,2105,2105,0,2105,2015,90,6323,6323,0,0,6323,6297,6069,189,7,23,4,5,26,24,2,0,0,0,6323,35,6288,6323,3237,3086,6069,42,021,012500
42,012600,0000004408369,00003091,1474,1474,0,1474,1357,117,3091,3091,0,0,3091,3081,3050,11,0,16,0,4,10,10,0,0,0,0,3091,16,3075,3091,1461,1630,3050,42,021,012600
42,012700,0000071549635,00002680,1106,1106,0,1106,1039,67,2680,2680,0,0,2680,2670,2665,1,2,1,1,0,10,4,0,0,0,6,2680,7,2673,2680,1313,1367,2665,42,021,012700
42,012800,0000032637698,00006366,2180,2180,0,2180,2019,161,6366,6366,0,0,6366,6339,5629,560,8,18,0,124,27,24,0,0,0,3,6366,155,6211,6366,3634,2732,5629,42,021,012800
42,012900,0000062993048,00003906,1552,1552,0,1552,1458,94,3906,3906,0,0,3906,3890,3871,8,1,6,0,4,16,13,3,0,0,0,3906,14,3892,3906,1937,1969,3871,42,021,012900
42,013000,0000001723735,00002837,1367,1367,0,1367,1232,135,2837,2837,0,0,2837,2828,2822,2,1,2,0,1,9,9,0,0,0,0,2837,14,2823,2837,1319,1518,2822,42,021,013000
42,013100,0000075653924,00002976,1193,1193,0,1193,1098,95,2976,2976,0,0,2976,2967,2964,2,1,0,0,0,9,9,0,0,0,0,2976,1,2975,2976,1466,1510,2964,42,021,013100
42,013200,0000050480465,00004126,1670,1670,0,1670,1573,97,4126,4126,0,0,4126,4115,4102,4,1,2,0,6,11,10,1,0,0,0,4126,17,4109,4126,2048,2078,4102,42,021,013200
42,013300,0000120492598,00006495,2642,2642,0,2642,2521,121,6495,6495,0,0,6495,6461,6423,3,12,8,5,10,34,28,4,2,0,0,6495,49,6446,6495,3183,3312,6423,42,021,013300
42,960100,0000001890716,00002526,1215,1215,0,1215,1089,126,2526,2526,0,0,2526,2514,2485,18,3,2,3,3,12,11,1,0,0,0,2526,23,2503,2526,1181,1345,2485,42,023,960100
42,960200,0001026760011,00003448,3377,3377,0,3377,1376,2001,3448,3448,0,0,3448,3432,3419,3,5,5,0,0,16,13,3,0,0,0,3448,11,3437,3448,1754,1694,3419,42,023,960200
42,020101,0000373994746,00006914,7149,7149,0,7149,2673,4476,6914,6914,0,0,6914,6769,6419,211,19,31,5,84,145,133,12,0,0,0,6914,349,6565,6914,3495,3419,6419,42,025,020101
42,020102,0000037465580,00004804,2193,2193,0,2193,1967,226,4804,4804,0,0,4804,4774,4725,30,2,13,2,2,30,28,2,0,0,0,4804,40,4764,4804,2346,2458,4725,42,025,020102
42,020200,0000194460283,00006670,2864,2864,0,2864,2558,306,6670,6670,0,0,6670,6641,6593,12,15,8,3,10,29,27,2,0,0,0,6670,46,6624,6670,3183,3487,6593,42,025,020200
42,020300,0000077900534,00006262,3050,3050,0,3050,2646,404,6262,6262,0,0,6262,6221,6156,23,11,19,0,12,41,39,2,0,0,0,6262,62,6200,6262,3066,3196,6156,42,025,020300
42,020400,0000004042633,00004230,2228,2228,0,2228,1878,350,4230,4230,0,0,4230,4199,4153,15,3,13,3,12,31,25,6,0,0,0,4230,60,4170,4230,1932,2298,4153,42,025,020400
42,020500,0000119208021,00006439,2689,2689,0,2689,2490,199,6439,6439,0,0,6439,6411,6341,14,19,23,0,14,28,28,0,0,0,0,6439,33,6406,6439,3170,3269,6341,42,025,020500
42,020600,0000004438746,00005537,2546,2546,0,2546,2362,184,5537,5537,0,0,5537,5498,5444,19,3,25,5,2,39,36,3,0,0,0,5537,37,5500,5537,2578,2959,5444,42,025,020600
42,020700,0000042278234,00005155,2237,2237,0,2237,2036,201,5155,5155,0,0,5155,5130,5080,6,8,30,0,6,25,23,2,0,0,0,5155,23,5132,5155,2604,2551,5080,42,025,020700
42,020800,0000126647942,00007543,3171,3171,0,3171,2871,300,7543,7543,0,0,7543,7505,7451,15,7,12,0,20,38,36,2,0,0,0,7543,84,7459,7543,3760,3783,7451,42,025,020800
42,020900,0000006444629,00005248,2365,2365,0,2365,2220,145,5248,5248,0,0,5248,5210,5158,8,9,9,2,24,38,36,2,0,0,0,5248,124,5124,5248,2499,2749,5158,42,025,020900
42,010100,0000219483412,00004004,1834,1834,0,1834,1552,282,4004,4004,0,0,4004,3990,3973,5,9,1,0,2,14,14,0,0,0,0,4004,14,3990,4004,2025,1979,3973,42,027,010100
42,010200,0000437426452,00002941,1488,1488,0,1488,1124,364,2941,2941,0,0,2941,2935,2925,0,4,3,3,0,6,6,0,0,0,0,2941,12,2929,2941,1519,1422,2925,42,027,010200
42,010300,0000002800940,00003494,1710,1710,0,1710,1550,160,3494,3494,0,0,3494,3473,3442,10,5,12,0,4,21,21,0,0,0,0,3494,8,3486,3494,1609,1885,3442,42,027,010300
42,010400,0000385007172,00003466,1687,1687,0,1687,1359,328,3466,3466,0,0,3466,3456,3441,0,6,9,0,0,10,9,1,0,0,0,3466,8,3458,3466,1672,1794,3441,42,027,010400
42,010500,0000324689485,00005038,2137,2137,0,2137,1929,208,5038,5038,0,0,5038,5009,4955,9,6,11,4,24,29,23,6,0,0,0,5038,47,4991,5038,2562,2476,4955,42,027,010500
42,010600,0000144122935,00004021,1644,1644,0,1644,1522,122,4021,4021,0,0,4021,4005,3974,7,19,1,0,4,16,16,0,0,0,0,4021,21,4000,4021,1985,2036,3974,42,027,010600
42,010700,0000161765402,00004277,1596,1596,0,1596,1527,69,4277,4277,0,0,4277,4259,4240,4,4,7,0,4,18,18,0,0,0,0,4277,14,4263,4277,2158,2119,4240,42,027,010700
42,010800,0000388498605,00004845,2228,2228,0,2228,1725,503,4845,4845,0,0,4845,4831,4784,19,4,21,1,2,14,12,2,0,0,0,4845,18,4827,4845,2382,2463,4784,42,027,010800
42,010900,0000269898369,00006537,2908,2908,0,2908,2543,365,6537,6537,0,0,6537,6523,6474,15,9,11,6,8,14,14,0,0,0,0,6537,24,6513,6537,3272,3265,6474,42,027,010900
42,011000,0000066948706,00006117,2559,2559,0,2559,2456,103,6117,6117,0,0,6117,6074,6030,15,4,10,6,9,43,42,1,0,0,0,6117,28,6089,6117,2954,3163,6030,42,027,011000
42,011100,0000004718722,00006395,2953,2953,0,2953,2796,157,6395,6395,0,0,6395,6343,6219,58,7,30,7,22,52,50,1,0,1,0,6395,38,6357,6395,2952,3443,6219,42,027,011100
42,011200,0000073851527,00005217,1386,1386,0,1386,1324,62,5217,5217,0,0,5217,5193,3970,1035,12,24,3,149,24,23,1,0,0,0,5217,183,5034,5217,3597,1620,3970,42,027,011200
42,011300,0000039571485,00006106,2895,2895,0,2895,2775,120,6106,6106,0,0,6106,5998,5267,323,12,328,2,66,108,102,5,1,0,0,6106,154,5952,6106,3232,2874,5267,42,027,011300
42,011400,0000024713059,00005314,2079,2079,0,2079,2016,63,5314,5314,0,0,5314,5224,4924,82,3,184,5,26,90,80,10,0,0,0,5314,93,5221,5314,2651,2663,4924,42,027,011400
42,011500,0000011373409,00008914,3698,3698,0,3698,3592,106,8914,8914,0,0,8914,8726,7410,306,9,931,4,66,188,173,15,0,0,0,8914,226,8688,8914,4589,4325,7410,42,027,011500
42,011600,0000018744359,00003694,1072,1072,0,1072,1043,29,3694,3694,0,0,3694,3665,3450,75,0,119,0,21,29,28,1,0,0,0,3694,39,3655,3694,1779,1915,3450,42,027,011600
42,011700,0000028681840,00004795,2141,2141,0,2141,2026,115,4795,4795,0,0,4795,4765,4550,64,4,109,0,38,30,30,0,0,0,0,4795,61,4734,4795,2283,2512,4550,42,027,011700
42,011800,0000082689613,00004657,1855,1855,0,1855,1752,103,4657,4657,0,0,4657,4592,4437,61,3,76,3,12,65,62,1,0,2,0,4657,54,4603,4657,2274,2383,4437,42,027,011800
42,011901,0000058626392,00002357,802,802,0,802,769,33,2357,2357,0,0,2357,2339,2328,7,0,3,0,1,18,18,0,0,0,0,2357,12,2345,2357,1244,1113,2328,42,027,011901
42,011902,0000113122571,00005149,2001,2001,0,2001,1919,82,5149,5149,0,0,5149,5118,4949,32,6,115,0,16,31,30,1,0,0,0,5149,30,5119,5149,2572,2577,4949,42,027,011902
42,012000,0000001405829,00006090,2421,2421,0,2421,2287,134,6090,6090,0,0,6090,6004,5501,129,4,305,7,58,86,86,0,0,0,0,6090,143,5947,6090,3475,2615,5501,42,027,012000
42,012100,0000000930549,00006378,458,458,0,458,448,10,6378,6378,0,0,6378,6234,4814,496,11,757,20,136,144,136,7,1,0,0,6378,271,6107,6378,2421,3957,4814,42,027,012100
42,012200,0000001476298,00005412,98,98,0,98,61,37,5412,5412,0,0,5412,5324,4490,276,13,381,14,150,88,82,6,0,0,0,5412,240,5172,5412,3250,2162,4490,42,027,012200
42,012300,0000001387383,00001822,819,819,0,819,788,31,1822,1822,0,0,1822,1789,1685,39,2,51,0,12,33,33,0,0,0,0,1822,46,1776,1822,939,883,1685,42,027,012300
42,012400,0000001242899,00004287,2005,2005,0,2005,1934,71,4287,4287,0,0,4287,4230,3611,83,5,488,1,42,57,54,1,0,2,0,4287,94,4193,4287,2482,1805,3611,42,027,012400
42,012500,0000000346239,00003548,1630,1630,0,1630,1581,49,3548,3548,0,0,3548,3510,3185,48,4,223,1,49,38,38,0,0,0,0,3548,86,3462,3548,1830,1718,3185,42,027,012500
42,012600,0000000543012,00003240,1430,1430,0,1430,1393,37,3240,3240,0,0,3240,3175,2780,56,4,306,5,24,65,55,9,1,0,0,3240,82,3158,3240,1786,1454,2780,42,027,012600
42,012700,0000002681901,00002716,1265,1265,0,1265,1231,34,2716,2716,0,0,2716,2681,2524,68,5,73,1,10,35,34,0,1,0,0,2716,52,2664,2716,1351,1365,2524,42,027,012700
42,012800,0000001749003,00004927,2362,2362,0,2362,2301,61,4927,4927,0,0,4927,4867,3802,222,10,784,1,48,60,55,4,0,1,0,4927,145,4782,4927,2477,2450,3802,42,027,012800
42,300101,0000006503124,00002911,1279,1279,0,1279,1243,36,2911,2911,0,0,2911,2894,2736,18,4,134,0,2,17,15,2,0,0,0,2911,31,2880,2911,1415,1496,2736,42,029,300101
42,300103,0000002119924,00002545,1212,1212,0,1212,1163,49,2545,2545,0,0,2545,2527,2179,220,3,108,0,17,18,17,1,0,0,0,2545,31,2514,2545,1168,1377,2179,42,029,300103
42,300104,0000006546721,00005018,2060,2060,0,2060,1998,62,5018,5018,0,0,5018,4988,4705,121,4,137,2,19,30,28,2,0,0,0,5018,55,4963,5018,2388,2630,4705,42,029,300104
42,300106,0000004171276,00004625,2413,2413,0,2413,2356,57,4625,4625,0,0,4625,4593,4149,85,8,327,0,24,32,30,2,0,0,0,4625,94,4531,4625,2065,2560,4149,42,029,300106
42,300107,0000020499571,00004299,1484,1484,0,1484,1452,32,4299,4299,0,0,4299,4269,4044,54,5,163,1,2,30,29,1,0,0,0,4299,24,4275,4299,2109,2190,4044,42,029,300107
42,300108,0000006321165,00006100,2807,2807,0,2807,2733,74,6100,6100,0,0,6100,6038,5304,161,8,546,1,18,62,57,5,0,0,0,6100,87,6013,6100,2907,3193,5304,42,029,300108
42,300109,0000005222228,00003564,1296,1296,0,1296,1278,18,3564,3564,0,0,3564,3537,3295,166,1,72,0,3,27,26,1,0,0,0,3564,28,3536,3564,1708,1856,3295,42,029,300109
42,300201,0000006470772,00005067,2035,2035,0,2035,1978,57,5067,5067,0,0,5067,5036,4675,229,8,121,0,3,31,25,6,0,0,0,5067,58,5009,5067,2395,2672,4675,42,029,300201
42,300202,0000014829389,00005203,1827,1827,0,1827,1780,47,5203,5203,0,0,5203,5171,4955,29,3,165,1,18,32,32,0,0,0,0,5203,53,5150,5203,2554,2649,4955,42,029,300202
42,300301,0000029650023,00003458,1443,1443,0,1443,1394,49,3458,3458,0,0,3458,3452,3261,93,3,71,0,24,6,6,0,0,0,0,3458,46,3412,3458,1643,1815,3261,42,029,300301
42,300302,0000014509813,00003673,1233,1233,0,1233,1214,19,3673,3673,0,0,3673,3663,3581,50,0,21,9,2,10,10,0,0,0,0,3673,20,3653,3673,1800,1873,3581,42,029,300302
42,300303,0000003064462,00002880,1256,1256,0,1256,1198,58,2880,2880,0,0,2880,2867,2754,71,2,35,1,4,13,12,1,0,0,0,2880,15,2865,2880,1398,1482,2754,42,029,300303
42,300400,0000003240936,00003059,1419,1419,0,1419,1361,58,3059,3059,0,0,3059,3017,2787,117,6,99,0,8,42,41,1,0,0,0,3059,47,3012,3059,1474,1585,2787,42,029,300400
42,300500,0000022193788,00006960,2652,2652,0,2652,2536,116,6960,6960,0,0,6960,6921,6600,116,5,173,2,25,39,35,4,0,0,0,6960,88,6872,6960,3488,3472,6600,42,029,300500
42,300600,0000004245584,00003497,1500,1500,0,1500,1422,78,3497,3497,0,0,3497,3432,2842,500,2,59,0,29,65,60,5,0,0,0,3497,85,3412,3497,1712,1785,2842,42,029,300600
42,300700,0000001304982,00004604,2202,2202,0,2202,2045,157,4604,4604,0,0,4604,4508,3945,380,12,73,0,98,96,82,13,0,1,0,4604,211,4393,4604,2189,2415,3945,42,029,300700
42,300800,0000001980919,00004208,2064,2064,0,2064,1994,70,4208,4208,0,0,4208,4148,3735,207,4,171,2,29,60,54,5,1,0,0,4208,101,4107,4208,2031,2177,3735,42,029,300800
42,300900,0000001764812,00002479,1027,1027,0,1027,999,28,2479,2479,0,0,2479,2458,2335,46,4,55,1,17,21,20,1,0,0,0,2479,35,2444,2479,1207,1272,2335,42,029,300900
42,301000,0000022770675,00006551,2604,2604,0,2604,2530,74,6551,6551,0,0,6551,6525,6306,89,5,113,2,10,26,23,3,0,0,0,6551,45,6506,6551,3167,3384,6306,42,029,301000
42,301100,0000001980588,00003305,1508,1508,0,1508,1412,96,3305,3305,0,0,3305,3274,3148,64,17,34,2,9,31,28,3,0,0,0,3305,39,3266,3305,1673,1632,3148,42,029,301100
42,301201,0000002978056,00000295,0,0,0,0,0,0,295,295,0,0,295,293,268,25,0,0,0,0,2,1,1,0,0,0,295,1,294,295,266,29,268,42,029,301201
42,301202,0000032069321,00005198,1960,1960,0,1960,1888,72,5198,5198,0,0,5198,5132,4818,234,5,51,2,22,66,65,1,0,0,0,5198,60,5138,5198,2547,2651,4818,42,029,301202
42,301300,0000027930794,00004566,1684,1684,0,1684,1649,35,4566,4566,0,0,4566,4554,4492,39,5,10,0,8,12,9,2,1,0,0,4566,32,4534,4566,2176,2390,4492,42,029,301300
42,301401,0000005820265,00002705,1276,1276,0,1276,1221,55,2705,2705,0,0,2705,2675,2576,63,4,27,0,5,30,29,1,0,0,0,2705,22,2683,2705,1342,1363,2576,42,029,301401
42,301402,0000028890195,00004676,1838,1838,0,1838,1791,47,4676,4676,0,0,4676,4654,4524,69,11,34,0,16,22,21,1,0,0,0,4676,45,4631,4676,2318,2358,4524,42,029,301402
42,301500,0000019356851,00001895,721,721,0,721,690,31,1895,1895,0,0,1895,1887,1866,12,3,2,0,4,8,7,1,0,0,0,1895,13,1882,1895,940,955,1866,42,029,301500
42,301600,0000049684713,00002556,1033,1033,0,1033,999,34,2556,2556,0,0,2556,2542,2509,6,7,12,0,8,14,14,0,0,0,0,2556,17,2539,2556,1311,1245,2509,42,029,301600
42,301700,0000042439597,00001787,587,587,0,587,569,18,1787,1787,0,0,1787,1779,1749,18,0,5,1,6,8,8,0,0,0,0,1787,13,1774,1787,906,881,1749,42,029,301700
42,301800,0000045968401,00003170,1121,1121,0,1121,1077,44,3170,3170,0,0,3170,3147,3100,19,4,21,1,2,23,19,2,0,2,0,3170,18,3152,3170,1601,1569,3100,42,029,301800
42,301900,0000025811437,00003551,1240,1240,0,1240,1214,26,3551,3551,0,0,3551,3538,3413,44,1,67,0,13,13,13,0,0,0,0,3551,36,3515,3551,1757,1794,3413,42,029,301900
42,302000,0000032449603,00004051,1397,1397,0,1397,1340,57,4051,4051,0,0,4051,4013,3863,63,7,69,1,10,38,33,5,0,0,0,4051,56,3995,4051,1974,2077,3863,42,029,302000
42,302101,0000022004980,00005360,1947,1947,0,1947,1893,54,5360,5360,0,0,5360,5292,4814,145,6,283,2,42,68,65,3,0,0,0,5360,144,5216,5360,2609,2751,4814,42,029,302101
42,302102,0000006481136,00003973,1513,1513,0,1513,1361,152,3973,3973,0,0,3973,3919,3546,161,2,182,2,26,54,48,6,0,0,0,3973,82,3891,3973,1654,2319,3546,42,029,302102
42,302202,0000019634172,00006109,2839,2839,0,2839,2754,85,6109,6109,0,0,6109,6043,5452,231,16,308,1,35,66,62,3,0,0,1,6109,101,6008,6109,2943,3166,5452,42,029,302202
42,302203,0000007103102,00004472,1549,1549,0,1549,1540,9,4472,4472,0,0,4472,4436,4041,262,8,95,4,26,36,35,1,0,0,0,4472,83,4389,4472,2190,2282,4041,42,029,302203
42,302204,0000006829736,00005918,2360,2360,0,2360,2324,36,5918,5918,0,0,5918,5864,5249,394,2,195,5,19,54,49,4,0,1,0,5918,146,5772,5918,2941,2977,5249,42,029,302204
42,302300,0000001021392,00002617,1285,1285,0,1285,1227,58,2617,2617,0,0,2617,2582,2286,199,8,69,1,19,35,32,3,0,0,0,2617,61,2556,2617,1227,1390,2286,42,029,302300
42,302400,0000001282223,00003954,1704,1704,0,1704,1632,72,3954,3954,0,0,3954,3850,2340,1085,16,64,6,339,104,101,3,0,0,0,3954,738,3216,3954,2008,1946,2340,42,029,302400
42,302500,0000001144166,00003880,1881,1881,0,1881,1796,85,3880,3880,0,0,3880,3827,3444,260,14,46,6,57,53,50,3,0,0,0,3880,149,3731,3880,1915,1965,3444,42,029,302500
42,302600,0000001082026,00004489,1671,1671,0,1671,1610,61,4489,4489,0,0,4489,4368,2925,1150,13,49,0,231,121,114,7,0,0,0,4489,576,3913,4489,2172,2317,2925,42,029,302600
42,302701,0000010018218,00007601,2878,2878,0,2878,2826,52,7601,7601,0,0,7601,7543,6958,291,3,253,1,37,58,55,3,0,0,0,7601,113,7488,7601,3735,3866,6958,42,029,302701
42,302702,0000004446054,00004683,2091,2091,0,2091,2038,53,4683,4683,0,0,4683,4632,3837,412,5,313,1,64,51,50,1,0,0,0,4683,174,4509,4683,2331,2352,3837,42,029,302702
42,302703,0000011316627,00003698,1248,1248,0,1248,1232,16,3698,3698,0,0,3698,3679,3505,88,1,75,0,10,19,19,0,0,0,0,3698,47,3651,3698,1839,1859,3505,42,029,302703
42,302704,0000005088183,00004513,1486,1486,0,1486,1458,28,4513,4513,0,0,4513,4486,4249,80,0,134,0,23,27,27,0,0,0,0,4513,76,4437,4513,2199,2314,4249,42,029,302704
42,302802,0000010298630,00004314,1461,1461,0,1461,1436,25,4314,4314,0,0,4314,4284,4179,44,2,58,0,1,30,28,2,0,0,0,4314,27,4287,4314,2120,2194,4179,42,029,302802
42,302803,0000002906841,00002269,1407,1407,0,1407,1332,75,2269,2269,0,0,2269,2267,2252,8,1,6,0,0,2,2,0,0,0,0,2269,7,2262,2269,919,1350,2252,42,029,302803
42,302804,0000007309059,00003711,1466,1466,0,1466,1426,40,3711,3711,0,0,3711,3698,3527,63,3,97,3,5,13,13,0,0,0,0,3711,39,3672,3711,1786,1925,3527,42,029,302804
42,302805,0000005727657,00006530,3162,3162,0,3162,2971,191,6530,6530,0,0,6530,6475,5922,337,3,170,3,40,55,50,5,0,0,0,6530,124,6406,6530,3189,3341,5922,42,029,302805
42,302901,0000010283294,00004508,1772,1772,0,1772,1715,57,4508,4508,0,0,4508,4483,4215,125,5,121,1,16,25,23,2,0,0,0,4508,50,4458,4508,2155,2353,4215,42,029,302901
42,302902,0000012333771,00005844,2023,2023,0,2023,1990,33,5844,5844,0,0,5844,5810,5513,143,2,130,0,22,34,31,2,1,0,0,5844,67,5777,5844,2916,2928,5513,42,029,302902
42,303000,0000010128792,00002678,1095,1095,0,1095,1023,72,2678,2678,0,0,2678,2659,2461,69,0,122,1,6,19,14,4,1,0,0,2678,21,2657,2678,1309,1369,2461,42,029,303000
42,303100,0000016581939,00004221,1413,1413,0,1413,1391,22,4221,4221,0,0,4221,4197,3984,24,2,172,2,13,24,24,0,0,0,0,4221,50,4171,4221,2089,2132,3984,42,029,303100
42,303200,0000024944018,00002850,1068,1068,0,1068,1030,38,2850,2850,0,0,2850,2822,2717,21,4,73,0,7,28,28,0,0,0,0,2850,50,2800,2850,1434,1416,2717,42,029,303200
42,303300,0000040271065,00006451,2526,2526,0,2526,2457,69,6451,6451,0,0,6451,6388,5982,133,2,91,2,178,63,58,5,0,0,0,6451,593,5858,6451,3202,3249,5982,42,029,303300
42,303401,0000001804178,00003327,1196,1196,0,1196,1152,44,3327,3327,0,0,3327,3254,2492,291,3,32,0,436,73,71,2,0,0,0,3327,1011,2316,3327,1694,1633,2492,42,029,303401
42,303402,0000001114478,00001946,771,771,0,771,716,55,1946,1946,0,0,1946,1916,1388,250,2,54,0,222,30,30,0,0,0,0,1946,459,1487,1946,924,1022,1388,42,029,303402
42,303500,0000040450689,00006317,2188,2188,0,2188,2131,57,6317,6317,0,0,6317,6246,5963,76,6,147,4,50,71,68,3,0,0,0,6317,250,6067,6317,3166,3151,5963,42,029,303500
42,303600,0000020600206,00002384,878,878,0,878,847,31,2384,2384,0,0,2384,2372,2326,19,0,22,5,0,12,12,0,0,0,0,2384,17,2367,2384,1187,1197,2326,42,029,303600
42,303700,0000031020436,00001150,446,446,0,446,429,17,1150,1150,0,0,1150,1140,1116,9,0,5,2,8,10,8,2,0,0,0,1150,23,1127,1150,581,569,1116,42,029,303700
42,303801,0000024497421,00003935,1306,1306,0,1306,1285,21,3935,3935,0,0,3935,3874,3418,375,27,18,0,36,61,54,7,0,0,0,3935,129,3806,3935,2127,1808,3418,42,029,303801
42,303802,0000023576650,00006840,2158,2158,0,2158,2134,24,6840,6840,0,0,6840,6773,6539,157,7,49,1,20,67,62,1,4,0,0,6840,61,6779,6840,3402,3438,6539,42,029,303802
42,303900,0000038936355,00009405,3150,3150,0,3150,3076,74,9405,9405,0,0,9405,9352,8789,328,16,176,5,38,53,50,3,0,0,0,9405,132,9273,9405,4506,4899,8789,42,029,303900
42,304000,0000009407219,00002857,1276,1276,0,1276,1205,71,2857,2857,0,0,2857,2814,2507,176,10,115,1,5,43,41,2,0,0,0,2857,54,2803,2857,1429,1428,2507,42,029,304000
42,304101,0000003483020,00003989,1851,1851,0,1851,1768,83,3989,3989,0,0,3989,3920,3343,376,3,137,3,58,69,60,9,0,0,0,3989,136,3853,3989,1926,2063,3343,42,029,304101
42,304102,0000002176134,00003600,1346,1346,0,1346,1291,55,3600,3600,0,0,3600,3542,3005,443,6,37,0,51,58,49,9,0,0,0,3600,132,3468,3600,1666,1934,3005,42,029,304102
42,304201,0000011573376,00006413,2432,2432,0,2432,2336,96,6413,6413,0,0,6413,6301,5255,700,16,227,6,97,112,95,15,2,0,0,6413,238,6175,6413,3134,3279,5255,42,029,304201
42,304202,0000010352608,00004955,2087,2087,0,2087,2012,75,4955,4955,0,0,4955,4882,3753,1016,4,64,0,45,73,58,14,1,0,0,4955,142,4813,4955,2389,2566,3753,42,029,304202
42,304300,0000029492346,00005822,2035,2035,0,2035,2003,32,5822,5822,0,0,5822,5776,5625,73,6,67,1,4,46,43,3,0,0,0,5822,30,5792,5822,2886,2936,5625,42,029,304300
42,304402,0000017708231,00007802,2454,2454,0,2454,2427,27,7802,7802,0,0,7802,7757,7414,89,5,232,0,17,45,42,3,0,0,0,7802,78,7724,7802,3860,3942,7414,42,029,304402
42,304403,0000004792108,00003893,1508,1508,0,1508,1480,28,3893,3893,0,0,3893,3848,3594,111,4,120,0,19,45,41,4,0,0,0,3893,66,3827,3893,1854,2039,3594,42,029,304403
42,304404,0000004549705,00004881,2068,2068,0,2068,2014,54,4881,4881,0,0,4881,4829,4518,106,4,185,1,15,52,50,1,0,1,0,4881,61,4820,4881,2427,2454,4518,42,029,304404
42,304500,0000027843747,00006850,2167,2167,0,2167,2132,35,6850,6850,0,0,6850,6815,6672,48,4,77,0,14,35,35,0,0,0,0,6850,66,6784,6850,3427,3423,6672,42,029,304500
42,304600,0000031163269,00003240,1045,1045,0,1045,1009,36,3240,3240,0,0,3240,3233,3100,81,1,38,2,11,7,7,0,0,0,0,3240,42,3198,3240,1667,1573,3100,42,029,304600
42,304700,0000034753425,00002031,745,745,0,745,715,30,2031,2031,0,0,2031,2007,1981,15,0,6,0,5,24,24,0,0,0,0,2031,17,2014,2031,1037,994,1981,42,029,304700
42,304800,0000002584088,00000959,460,460,0,460,412,48,959,959,0,0,959,951,931,3,0,13,0,4,8,8,0,0,0,0,959,6,953,959,445,514,931,42,029,304800
42,304900,0000065030610,00006278,2134,2134,0,2134,2054,80,6278,6278,0,0,6278,6230,6115,68,15,12,2,18,48,46,0,2,0,0,6278,62,6216,6278,2986,3292,6115,42,029,304900
42,305000,0000001273845,00001287,500,500,0,500,474,26,1287,1287,0,0,1287,1276,1261,3,3,1,0,8,11,10,1,0,0,0,1287,13,1274,1287,614,673,1261,42,029,305000
42,305100,0000056328185,00007054,2458,2458,0,2458,2406,52,7054,7054,0,0,7054,6997,6740,185,12,25,3,32,57,55,2,0,0,0,7054,69,6985,7054,3610,3444,6740,42,029,305100
42,305200,0000034085247,00007074,2580,2580,0,2580,2522,58,7074,7074,0,0,7074,7036,6745,234,10,28,0,19,38,33,5,0,0,0,7074,50,7024,7074,3488,3586,6745,42,029,305200
42,305300,0000015459830,00005116,1974,1974,0,1974,1874,100,5116,5116,0,0,5116,5029,3663,1279,6,20,0,61,87,84,3,0,0,0,5116,183,4933,5116,2493,2623,3663,42,029,305300
42,305400,0000001350032,00002366,947,947,0,947,868,79,2366,2366,0,0,2366,2291,1303,878,4,14,1,91,75,70,5,0,0,0,2366,252,2114,2366,1080,1286,1303,42,029,305400
42,305500,0000001821109,00003507,1511,1511,0,1511,1330,181,3507,3507,0,0,3507,3363,826,2369,11,11,1,145,144,139,5,0,0,0,3507,328,3179,3507,1610,1897,826,42,029,305500
42,305600,0000000803789,00002730,1057,1057,0,1057,933,124,2730,2730,0,0,2730,2628,887,1509,18,13,1,200,102,92,9,1,0,0,2730,432,2298,2730,1295,1435,887,42,029,305600
42,305700,0000000824408,00002235,845,845,0,845,809,36,2235,2235,0,0,2235,2185,1526,571,6,19,0,63,50,46,4,0,0,0,2235,153,2082,2235,1076,1159,1526,42,029,305700
42,305800,0000004405224,00000997,419,419,0,419,376,43,997,997,0,0,997,952,347,559,2,0,3,41,45,41,4,0,0,0,997,89,908,997,464,533,347,42,029,305800
42,305900,0000000855200,00000610,211,211,0,211,200,11,610,610,0,0,610,585,461,110,3,0,0,11,25,15,10,0,0,0,610,71,539,610,298,312,461,42,029,305900
42,306000,0000040608947,00005157,1860,1860,0,1860,1801,59,5157,5157,0,0,5157,5088,4558,471,7,22,6,24,69,67,2,0,0,0,5157,87,5070,5157,2591,2566,4558,42,029,306000
42,306100,0000044363279,00000859,375,375,0,375,349,26,859,859,0,0,859,858,807,11,2,5,3,30,1,1,0,0,0,0,859,74,785,859,440,419,807,42,029,306100
42,306200,0000044577614,00005265,1698,1698,0,1698,1633,65,5265,5265,0,0,5265,5168,4812,127,12,23,0,194,97,89,8,0,0,0,5265,695,4570,5265,2750,2515,4812,42,029,306200
42,306300,0000001644167,00002652,889,889,0,889,864,25,2652,2652,0,0,2652,2580,2088,222,11,0,0,259,72,71,1,0,0,0,2652,451,2201,2652,1298,1354,2088,42,029,306300
42,306400,0000001276135,00001108,361,361,0,361,345,16,1108,1108,0,0,1108,1085,773,184,10,3,0,115,23,23,0,0,0,0,1108,422,686,1108,588,520,773,42,029,306400
42,306500,0000041789693,00009083,2831,2831,0,2831,2700,131,9083,9083,0,0,9083,8937,7712,333,37,118,4,733,146,145,1,0,0,0,9083,2065,7018,9083,4940,4143,7712,42,029,306500
42,306600,0000025560074,00002797,979,979,0,979,957,22,2797,2797,0,0,2797,2764,2700,25,1,26,1,11,33,25,8,0,0,0,2797,47,2750,2797,1421,1376,2700,42,029,306600
42,306700,0000034307102,00003850,1237,1237,0,1237,1210,27,3850,3850,0,0,3850,3822,3724,43,7,29,0,19,28,28,0,0,0,0,3850,49,3801,3850,1917,1933,3724,42,029,306700
42,306800,0000026485262,00001485,527,527,0,527,515,12,1485,1485,0,0,1485,1465,1439,12,0,2,0,12,20,14,6,0,0,0,1485,54,1431,1485,742,743,1439,42,029,306800
42,306900,0000030711771,00004583,1390,1390,0,1390,1365,25,4583,4583,0,0,4583,4552,4431,44,4,30,2,41,31,31,0,0,0,0,4583,109,4474,4583,2280,2303,4431,42,029,306900
42,307000,0000024839144,00002812,1093,1093,0,1093,1026,67,2812,2812,0,0,2812,2776,2622,75,5,9,0,65,36,36,0,0,0,0,2812,166,2646,2812,1389,1423,2622,42,029,307000
42,307100,0000029352838,00001632,539,539,0,539,525,14,1632,1632,0,0,1632,1625,1559,20,0,9,0,37,7,6,1,0,0,0,1632,152,1480,1632,841,791,1559,42,029,307100
42,307200,0000044607567,00001125,459,459,0,459,433,26,1125,1125,0,0,1125,1119,1049,55,0,5,0,10,6,4,2,0,0,0,1125,23,1102,1125,548,577,1049,42,029,307200
42,307300,0000016181976,00002582,1025,1025,0,1025,946,79,2582,2582,0,0,2582,2564,2419,110,4,16,1,14,18,17,1,0,0,0,2582,21,2561,2582,1256,1326,2419,42,029,307300
42,307400,0000003227479,00003373,1321,1321,0,1321,1243,78,3373,3373,0,0,3373,3348,3067,232,5,5,1,38,25,20,5,0,0,0,3373,127,3246,3373,1625,1748,3067,42,029,307400
42,307500,0000027631646,00002444,818,818,0,818,802,16,2444,2444,0,0,2444,2429,2284,126,4,7,0,8,15,12,3,0,0,0,2444,19,2425,2444,1235,1209,2284,42,029,307500
42,307600,0000002288660,00001217,429,429,0,429,413,16,1217,1217,0,0,1217,1205,1073,102,0,2,0,28,12,11,1,0,0,0,1217,60,1157,1217,592,625,1073,42,029,307600
42,307700,0000046792760,00002485,858,858,0,858,829,29,2485,2485,0,0,2485,2462,2399,23,7,6,0,27,23,22,1,0,0,0,2485,57,2428,2485,1249,1236,2399,42,029,307700
42,307800,0000043486076,00002095,743,743,0,743,725,18,2095,2095,0,0,2095,2064,1921,77,8,7,0,51,31,30,0,1,0,0,2095,56,2039,2095,1068,1027,1921,42,029,307800
42,307900,0000047154131,00004319,1018,1018,0,1018,986,32,4319,4319,0,0,4319,4277,2648,1490,2,11,0,126,42,39,2,1,0,0,4319,282,4037,4319,2080,2239,2648,42,029,307900
42,308000,0000004956866,00004315,1825,1825,0,1825,1703,122,4315,4315,0,0,4315,4227,3355,512,4,27,10,319,88,83,4,1,0,0,4315,697,3618,4315,1986,2329,3355,42,029,308000
42,308100,0000051885744,00005516,1837,1837,0,1837,1759,78,5516,5516,0,0,5516,5445,5128,162,14,13,0,128,71,66,5,0,0,0,5516,292,5224,5516,2855,2661,5128,42,029,308100
42,308200,0000035916332,00002634,1007,1007,0,1007,956,51,2634,2634,0,0,2634,2606,2494,51,10,7,0,44,28,27,1,0,0,0,2634,110,2524,2634,1317,1317,2494,42,029,308200
42,310200,0000001333254,00000627,46,46,0,46,45,1,627,627,0,0,627,622,457,162,3,0,0,0,5,5,0,0,0,0,627,6,621,627,544,83,457,42,029,310200
42,310400,0000000237641,00002921,0,0,0,0,0,0,2921,2921,0,0,2921,2877,2480,356,4,33,0,4,44,41,0,3,0,0,2921,72,2849,2921,1060,1861,2480,42,029,310400
42,310500,0000000734513,00000650,370,370,0,370,357,13,650,650,0,0,650,650,642,4,0,4,0,0,0,0,0,0,0,0,650,4,646,650,193,457,642,42,029,310500
42,310900,0000000855131,00000966,12,12,0,12,12,0,966,966,0,0,966,965,589,371,1,4,0,0,1,1,0,0,0,0,966,53,913,966,675,291,589,42,029,310900
42,990100,0000319498650,00006216,4099,4099,0,4099,2625,1474,6216,6216,0,0,6216,6174,6089,65,5,11,0,4,42,39,3,0,0,0,6216,16,6200,6216,3094,3122,6089,42,031,990100
42,990200,0000177799325,00003715,1917,1917,0,1917,1378,539,3715,3715,0,0,3715,3698,3678,8,7,4,0,1,17,17,0,0,0,0,3715,4,3711,3715,1876,1839,3678,42,031,990200
42,990300,0000193637021,00004883,2045,2045,0,2045,1858,187,4883,4883,0,0,4883,4853,4798,12,1,37,2,3,30,30,0,0,0,0,4883,20,4863,4883,2393,2490,4798,42,031,990300
42,990400,0000130389579,00003781,1712,1712,0,1712,1548,164,3781,3781,0,0,3781,3769,3755,0,10,4,0,0,12,12,0,0,0,0,3781,18,3763,3781,1841,1940,3755,42,031,990400
42,990500,0000211454440,00004254,1903,1903,0,1903,1591,312,4254,4254,0,0,4254,4232,4203,3,7,9,0,10,22,21,0,0,1,0,4254,25,4229,4254,2105,2149,4203,42,031,990500
42,990600,0000003866752,00006185,2192,2192,0,2192,2000,192,6185,6185,0,0,6185,6138,5848,215,5,61,0,9,47,46,1,0,0,0,6185,51,6134,6185,2611,3574,5848,42,031,990600
42,990700,0000152556582,00004759,2172,2172,0,2172,1947,225,4759,4759,0,0,4759,4745,4732,8,4,1,0,0,14,14,0,0,0,0,4759,15,4744,4759,2299,2460,4732,42,031,990700
42,990800,0000192723293,00004110,1826,1826,0,1826,1649,177,4110,4110,0,0,4110,4094,4070,8,6,6,0,4,16,16,0,0,0,0,4110,16,4094,4110,1972,2138,4070,42,031,990800
42,990900,0000178385565,00003862,1560,1560,0,1560,1456,104,3862,3862,0,0,3862,3845,3825,10,0,9,0,1,17,17,0,0,0,0,3862,7,3855,3862,1971,1891,3825,42,031,990900
42,330100,0000057859253,00005156,1990,1990,0,1990,1880,110,5156,5156,0,0,5156,5123,5096,7,2,17,1,0,33,33,0,0,0,0,5156,19,5137,5156,2380,2776,5096,42,033,330100
42,330200,0000002498631,00003624,1734,1734,0,1734,1581,153,3624,3624,0,0,3624,3599,3559,11,5,18,1,5,25,25,0,0,0,0,3624,14,3610,3624,1701,1923,3559,42,033,330200
42,330300,0000006159790,00004499,2222,2222,0,2222,2033,189,4499,4499,0,0,4499,4462,4416,13,3,25,3,2,37,37,0,0,0,0,4499,20,4479,4499,2083,2416,4416,42,033,330300
42,330400,0000076365362,00006444,3056,3056,0,3056,2524,532,6444,6444,0,0,6444,6421,6337,16,5,53,2,8,23,23,0,0,0,0,6444,33,6411,6444,3222,3222,6337,42,033,330400
42,330500,0000344423873,00004620,2372,2372,0,2372,1785,587,4620,4620,0,0,4620,4596,4590,0,3,2,1,0,24,24,0,0,0,0,4620,8,4612,4620,2328,2292,4590,42,033,330500
42,330600,0000149902250,00003030,1332,1332,0,1332,1120,212,3030,3030,0,0,3030,3015,2977,25,10,1,0,2,15,14,1,0,0,0,3030,24,3006,3030,1476,1554,2977,42,033,330600
42,330700,0000519544536,00002602,1617,1617,0,1617,912,705,2602,2602,0,0,2602,2571,2435,125,3,3,0,5,31,31,0,0,0,0,2602,33,2569,2602,1409,1193,2435,42,033,330700
42,330800,0000234510508,00007030,3056,3056,0,3056,2743,313,7030,7030,0,0,7030,7005,6986,2,7,8,0,2,25,25,0,0,0,0,7030,30,7000,7030,3472,3558,6986,42,033,330800
42,330900,0000100929410,00005141,2331,2331,0,2331,2131,200,5141,5141,0,0,5141,5117,5091,4,6,8,0,8,24,24,0,0,0,0,5141,30,5111,5141,2501,2640,5091,42,033,330900
42,331000,0000194858506,00005501,2221,2221,0,2221,2073,148,5501,5501,0,0,5501,5480,5441,9,18,9,0,3,21,15,6,0,0,0,5501,8,5493,5501,2708,2793,5441,42,033,331000
42,331100,0000002795268,00003448,1807,1807,0,1807,1660,147,3448,3448,0,0,3448,3429,3381,25,5,14,0,4,19,19,0,0,0,0,3448,13,3435,3448,1618,1830,3381,42,033,331100
42,331200,0000001910440,00003183,1519,1519,0,1519,1410,109,3183,3183,0,0,3183,3177,3147,23,0,7,0,0,6,6,0,0,0,0,3183,9,3174,3183,1515,1668,3147,42,033,331200
42,331300,0000065358093,00004682,2069,2069,0,2069,1950,119,4682,4682,0,0,4682,4663,4630,6,3,22,0,2,19,19,0,0,0,0,4682,11,4671,4682,2249,2433,4630,42,033,331300
42,331400,0000316438847,00007301,3306,3306,0,3306,2917,389,7301,7301,0,0,7301,7281,7247,11,11,8,0,4,20,19,1,0,0,0,7301,19,7282,7301,3546,3755,7247,42,033,331400
42,331500,0000260471789,00002061,1023,1023,0,1023,776,247,2061,2061,0,0,2061,2054,2047,0,2,2,1,2,7,7,0,0,0,0,2061,5,2056,2061,1045,1016,2047,42,033,331500
42,331600,0000198170712,00002821,1351,1351,0,1351,1121,230,2821,2821,0,0,2821,2810,2803,2,1,1,0,3,11,11,0,0,0,0,2821,3,2818,2821,1399,1422,2803,42,033,331600
42,331700,0000114309864,00006704,2314,2314,0,2314,2036,278,6704,6704,0,0,6704,6688,5545,956,9,12,1,165,16,15,1,0,0,0,6704,175,6529,6704,4165,2539,5545,42,033,331700
42,331800,0000096231638,00002949,1361,1361,0,1361,1185,176,2949,2949,0,0,2949,2938,2929,1,2,5,0,1,11,11,0,0,0,0,2949,4,2945,2949,1445,1504,2929,42,033,331800
42,331900,0000228794926,00002586,1174,1174,0,1174,948,226,2586,2586,0,0,2586,2571,2561,3,2,5,0,0,15,15,0,0,0,0,2586,13,2573,2586,1319,1267,2561,42,033,331900
42,970100,0000975139792,00003582,3202,3202,0,3202,1576,1626,3582,3582,0,0,3582,3568,3553,4,7,2,1,1,14,14,0,0,0,0,3582,8,3574,3582,1753,1829,3553,42,035,970100
42,970200,0000359906624,00005193,2548,2548,0,2548,2088,460,5193,5193,0,0,5193,5175,5129,11,8,18,2,7,18,18,0,0,0,0,5193,17,5176,5193,2568,2625,5129,42,035,970200
42,970300,0000433328147,00003812,1995,1995,0,1995,1536,459,3812,3812,0,0,3812,3787,3761,3,4,16,1,2,25,25,0,0,0,0,3812,22,3790,3812,1850,1962,3761,42,035,970300
42,970400,0000038532756,00004676,2031,2031,0,2031,1926,105,4676,4676,0,0,4676,4666,4635,13,1,12,2,3,10,10,0,0,0,0,4676,3,4673,4676,2287,2389,4635,42,035,970400
42,970500,0000078229678,00004113,1717,1717,0,1717,1658,59,4113,4113,0,0,4113,4100,4058,22,1,16,0,3,13,12,1,0,0,0,4113,15,4098,4113,2063,2050,4058,42,035,970500
42,970600,0000002188187,00001871,978,978,0,978,893,85,1871,1871,0,0,1871,1850,1810,15,5,10,1,9,21,21,0,0,0,0,1871,18,1853,1871,816,1055,1810,42,035,970600
42,970700,0000004314719,00007278,2587,2587,0,2587,2413,174,7278,7278,0,0,7278,7217,6997,116,9,65,0,30,61,61,0,0,0,0,7278,84,7194,7278,3324,3954,6997,42,035,970700
42,970800,0000172620778,00003869,1582,1582,0,1582,1460,122,3869,3869,0,0,3869,3852,3838,5,3,6,0,0,17,17,0,0,0,0,3869,14,3855,3869,1948,1921,3838,42,035,970800
42,970900,0000243069697,00003520,1526,1526,0,1526,1223,303,3520,3520,0,0,3520,3503,3483,8,4,6,2,0,17,17,0,0,0,0,3520,24,3496,3520,1780,1740,3483,42,035,970900
42,050100,0000250491830,00005241,2878,2878,0,2878,2137,741,5241,5241,0,0,5241,5218,5191,3,16,4,0,4,23,23,0,0,0,0,5241,27,5214,5241,2622,2619,5191,42,037,050100
42,050200,0000234917142,00005605,2318,2318,0,2318,2096,222,5605,5605,0,0,5605,5576,5543,8,8,13,0,4,29,26,3,0,0,0,5605,18,5587,5605,2721,2884,5543,42,037,050200
42,050300,0000114641169,00004770,1920,1920,0,1920,1848,72,4770,4770,0,0,4770,4732,4687,14,2,19,0,10,38,38,0,0,0,0,4770,28,4742,4770,2409,2361,4687,42,037,050300
42,050400,0000075078608,00004315,1822,1822,0,1822,1634,188,4315,4315,0,0,4315,4303,4257,20,3,11,6,6,12,12,0,0,0,0,4315,39,4276,4315,2093,2222,4257,42,037,050400
42,050500,0000059625348,00003793,1673,1673,0,1673,1513,160,3793,3793,0,0,3793,3779,3755,7,1,7,0,9,14,14,0,0,0,0,3793,15,3778,3793,1837,1956,3755,42,037,050500
42,050600,0000004169273,00005740,2518,2518,0,2518,2321,197,5740,5740,0,0,5740,5696,5542,49,23,32,2,48,44,33,10,1,0,0,5740,134,5606,5740,2647,3093,5542,42,037,050600
42,050700,0000003856262,00005034,2474,2474,0,2474,2274,200,5034,5034,0,0,5034,5008,4920,46,7,14,3,18,26,23,3,0,0,0,5034,41,4993,5034,2390,2644,4920,42,037,050700
42,050800,0000007087438,00003429,1599,1599,0,1599,1527,72,3429,3429,0,0,3429,3409,3371,11,3,17,0,7,20,19,0,1,0,0,3429,30,3399,3429,1622,1807,3371,42,037,050800
42,050900,0000023802249,00002572,974,974,0,974,949,25,2572,2572,0,0,2572,2559,2500,6,0,50,1,2,13,13,0,0,0,0,2572,12,2560,2572,1238,1334,2500,42,037,050900
42,051000,0000003752565,00002500,1116,1116,0,1116,1069,47,2500,2500,0,0,2500,2473,2395,34,7,16,0,21,27,27,0,0,0,0,2500,46,2454,2500,1194,1306,2395,42,037,051000
42,051100,0000003003084,00005971,1203,1203,0,1203,1151,52,5971,5971,0,0,5971,5916,5544,236,10,63,3,60,55,49,6,0,0,0,5971,123,5848,5971,2422,3549,5544,42,037,051100
42,051200,0000004617757,00003904,2080,2080,0,2080,1860,220,3904,3904,0,0,3904,3873,3745,52,8,58,2,8,31,28,3,0,0,0,3904,46,3858,3904,1786,2118,3745,42,037,051200
42,051300,0000033163050,00003113,1361,1361,0,1361,1279,82,3113,3113,0,0,3113,3091,3046,28,0,7,4,6,22,12,10,0,0,0,3113,15,3098,3113,1466,1647,3046,42,037,051300
42,051400,0000059150780,00002485,1049,1049,0,1049,992,57,2485,2485,0,0,2485,2476,2456,0,4,16,0,0,9,9,0,0,0,0,2485,5,2480,2485,1223,1262,2456,42,037,051400
42,051500,0000380202557,00005679,2748,2748,0,2748,2265,483,5679,5679,0,0,5679,5671,5650,2,2,7,0,10,8,7,1,0,0,0,5679,30,5649,5679,2853,2826,5650,42,037,051500
42,110100,0000320171292,00006116,2893,2893,0,2893,2003,890,6116,6116,0,0,6116,6088,6067,11,7,2,0,1,28,28,0,0,0,0,6116,16,6100,6116,3164,2952,6067,42,039,110100
42,110200,0000302080058,00008033,3201,3201,0,3201,2784,417,8033,8033,0,0,8033,7964,7590,321,14,19,5,15,69,59,10,0,0,0,8033,94,7939,8033,3741,4292,7590,42,039,110200
42,110300,0000284109980,00005163,2136,2136,0,2136,1855,281,5163,5163,0,0,5163,5127,5069,38,8,8,1,3,36,36,0,0,0,0,5163,16,5147,5163,2572,2591,5069,42,039,110300
42,110400,0000125011981,00003236,1689,1689,0,1689,1263,426,3236,3236,0,0,3236,3201,3162,17,16,4,0,2,35,35,0,0,0,0,3236,14,3222,3236,1645,1591,3162,42,039,110400
42,110500,0000129083718,00005821,3880,3880,0,3880,2507,1373,5821,5821,0,0,5821,5799,5770,4,5,17,2,1,22,20,2,0,0,0,5821,21,5800,5821,2895,2926,5770,42,039,110500
42,110600,0000100665975,00003092,1249,1249,0,1249,1155,94,3092,3092,0,0,3092,3080,3063,2,6,7,0,2,12,12,0,0,0,0,3092,11,3081,3092,1570,1522,3063,42,039,110600
42,110700,0000089488404,00004193,1542,1542,0,1542,1444,98,4193,4193,0,0,4193,4164,4079,57,11,4,0,13,29,28,0,0,0,1,4193,13,4180,4193,2123,2070,4079,42,039,110700
42,110800,0000270598538,00005080,2061,2061,0,2061,1868,193,5080,5080,0,0,5080,5056,5032,12,4,6,0,2,24,21,1,2,0,0,5080,24,5056,5080,2637,2443,5032,42,039,110800
42,110900,0000220143203,00003328,1423,1423,0,1423,1191,232,3328,3328,0,0,3328,3312,3281,12,8,6,3,2,16,16,0,0,0,0,3328,17,3311,3328,1680,1648,3281,42,039,110900
42,111000,0000089267972,00002485,1108,1108,0,1108,999,109,2485,2485,0,0,2485,2479,2459,4,7,5,0,4,6,6,0,0,0,0,2485,7,2478,2485,1251,1234,2459,42,039,111000
42,111100,0000005831423,00003549,1581,1581,0,1581,1454,127,3549,3549,0,0,3549,3526,3437,65,15,6,0,3,23,23,0,0,0,0,3549,35,3514,3549,1625,1924,3437,42,039,111100
42,111200,0000001694222,00002597,1161,1161,0,1161,1069,92,2597,2597,0,0,2597,2585,2560,9,3,11,0,2,12,11,1,0,0,0,2597,17,2580,2597,1160,1437,2560,42,039,111200
42,111300,0000218199497,00005707,2612,2612,0,2612,2203,409,5707,5707,0,0,5707,5690,5656,13,6,8,3,4,17,14,3,0,0,0,5707,15,5692,5707,2811,2896,5656,42,039,111300
42,111400,0000041257453,00004736,1977,1977,0,1977,1901,76,4736,4736,0,0,4736,4710,4567,103,11,25,0,4,26,24,2,0,0,0,4736,26,4710,4736,2280,2456,4567,42,039,111400
42,111500,0000003167121,00005287,2560,2560,0,2560,2345,215,5287,5287,0,0,5287,5202,4954,203,7,27,2,9,85,84,1,0,0,0,5287,39,5248,5287,2435,2852,4954,42,039,111500
42,111600,0000003323561,00004162,2175,2175,0,2175,1930,245,4162,4162,0,0,4162,4042,3613,379,11,13,3,23,120,113,7,0,0,0,4162,60,4102,4162,1938,2224,3613,42,039,111600
42,111700,0000010705013,00004727,1457,1457,0,1457,1358,99,4727,4727,0,0,4727,4679,4498,109,7,50,1,14,48,45,3,0,0,0,4727,53,4674,4727,2019,2708,4498,42,039,111700
42,111800,0000076543735,00005499,2599,2599,0,2599,2395,204,5499,5499,0,0,5499,5466,5359,55,16,25,1,10,33,32,0,0,1,0,5499,31,5468,5499,2643,2856,5359,42,039,111800
42,111900,0000196289919,00003580,1387,1387,0,1387,1260,127,3580,3580,0,0,3580,3550,3510,18,13,5,1,3,30,25,5,0,0,0,3580,18,3562,3580,1822,1758,3510,42,039,111900
42,112000,0000135308321,00003975,3725,3725,0,3725,1694,2031,3975,3975,0,0,3975,3948,3927,5,9,6,1,0,27,26,1,0,0,0,3975,10,3965,3975,1957,2018,3927,42,039,112000
42,010100,0000005597058,00004984,2271,2271,0,2271,2148,123,4984,4984,0,0,4984,4888,4754,50,14,41,4,25,96,92,4,0,0,0,4984,81,4903,4984,2362,2622,4754,42,041,010100
42,010201,0000010905674,00003919,1633,1633,0,1633,1582,51,3919,3919,0,0,3919,3873,3790,25,3,41,0,14,46,44,2,0,0,0,3919,27,3892,3919,1916,2003,3790,42,041,010201
42,010202,0000010587597,00008045,3304,3304,0,3304,3188,116,8045,8045,0,0,8045,7950,7304,191,9,374,0,72,95,85,9,1,0,0,8045,161,7884,8045,3771,4274,7304,42,041,010202
42,010300,0000003429858,00003913,1995,1995,0,1995,1852,143,3913,3913,0,0,3913,3836,3665,36,4,116,2,13,77,75,2,0,0,0,3913,47,3866,3913,1908,2005,3665,42,041,010300
42,010400,0000002748402,00003676,1607,1607,0,1607,1568,39,3676,3676,0,0,3676,3641,3564,5,10,57,0,5,35,32,3,0,0,0,3676,29,3647,3676,1763,1913,3564,42,041,010400
42,010500,0000002959806,00003960,1922,1922,0,1922,1819,103,3960,3960,0,0,3960,3927,3773,22,2,115,1,14,33,33,0,0,0,0,3960,54,3906,3960,1821,2139,3773,42,041,010500
42,010600,0000004032607,00003995,2027,2027,0,2027,1926,101,3995,3995,0,0,3995,3956,3856,23,3,52,0,22,39,39,0,0,0,0,3995,43,3952,3995,1893,2102,3856,42,041,010600
42,010700,0000002494536,00003808,1634,1634,0,1634,1606,28,3808,3808,0,0,3808,3782,3728,8,0,32,2,12,26,25,0,1,0,0,3808,35,3773,3808,1813,1995,3728,42,041,010700
42,010800,0000001841489,00003541,1783,1783,0,1783,1695,88,3541,3541,0,0,3541,3502,3415,39,7,21,2,18,39,37,2,0,0,0,3541,48,3493,3541,1723,1818,3415,42,041,010800
42,010900,0000003685927,00004442,2062,2062,0,2062,1994,68,4442,4442,0,0,4442,4425,4267,41,2,100,0,15,17,17,0,0,0,0,4442,50,4392,4442,2068,2374,4267,42,041,010900
42,011000,0000005852091,00005507,1081,1081,0,1081,1048,33,5507,5507,0,0,5507,5474,3583,1790,8,36,1,56,33,33,0,0,0,0,5507,518,4989,5507,4216,1291,3583,42,041,011000
42,011100,0000017105107,00007488,3377,3377,0,3377,3272,105,7488,7488,0,0,7488,7403,7096,58,12,194,9,34,85,83,2,0,0,0,7488,73,7415,7488,3484,4004,7096,42,041,011100
42,011200,0000000771550,00001521,742,742,0,742,719,23,1521,1521,0,0,1521,1501,1450,8,1,37,0,5,20,19,1,0,0,0,1521,8,1513,1521,697,824,1450,42,041,011200
42,011301,0000014901053,00002931,1340,1340,0,1340,1270,70,2931,2931,0,0,2931,2912,2790,21,2,87,0,12,19,17,2,0,0,0,2931,36,2895,2931,1422,1509,2790,42,041,011301
42,011302,0000007620836,00005373,2008,2008,0,2008,1962,46,5373,5373,0,0,5373,5333,5098,44,3,167,0,21,40,37,3,0,0,0,5373,63,5310,5373,2633,2740,5098,42,041,011302
42,011303,0000006743929,00006078,2154,2154,0,2154,2111,43,6078,6078,0,0,6078,6032,5723,28,4,264,1,12,46,46,0,0,0,0,6078,52,6026,6078,2979,3099,5723,42,041,011303
42,011304,0000005880967,00005414,2469,2469,0,2469,2388,81,5414,5414,0,0,5414,5335,5017,55,13,222,6,22,79,76,3,0,0,0,5414,60,5354,5414,2480,2934,5017,42,041,011304
42,011305,0000010878870,00004339,2019,2019,0,2019,1846,173,4339,4339,0,0,4339,4312,4052,60,11,164,3,22,27,25,2,0,0,0,4339,78,4261,4339,2200,2139,4052,42,041,011305
42,011400,0000002900737,00004402,2161,2161,0,2161,2054,107,4402,4402,0,0,4402,4345,4238,24,5,71,0,7,57,54,3,0,0,0,4402,42,4360,4402,2108,2294,4238,42,041,011400
42,011500,0000003800604,00004640,2008,2008,0,2008,1969,39,4640,4640,0,0,4640,4599,4530,15,3,33,0,18,41,37,4,0,0,0,4640,33,4607,4640,2207,2433,4530,42,041,011500
42,011601,0000010536811,00005900,2419,2419,0,2419,2347,72,5900,5900,0,0,5900,5857,5556,135,3,94,2,67,43,32,11,0,0,0,5900,112,5788,5900,2562,3338,5556,42,041,011601
42,011602,0000009319823,00003345,1139,1139,0,1139,1119,20,3345,3345,0,0,3345,3326,3258,8,3,53,0,4,19,19,0,0,0,0,3345,18,3327,3345,1671,1674,3258,42,041,011602
42,011603,0000014493019,00006093,1640,1640,0,1640,1591,49,6093,6093,0,0,6093,6024,5832,54,8,106,3,21,69,59,5,4,1,0,6093,89,6004,6093,2756,3337,5832,42,041,011603
42,011700,0000067705231,00005530,2165,2165,0,2165,2073,92,5530,5530,0,0,5530,5499,5452,12,2,31,1,1,31,24,7,0,0,0,5530,26,5504,5530,2780,2750,5452,42,041,011700
42,011801,0000064134909,00005885,2333,2333,0,2333,2251,82,5885,5885,0,0,5885,5845,5706,16,2,93,3,25,40,36,1,1,2,0,5885,45,5840,5885,2904,2981,5706,42,041,011801
42,011802,0000020065575,00004707,1852,1852,0,1852,1810,42,4707,4707,0,0,4707,4666,4478,23,6,151,1,7,41,37,4,0,0,0,4707,32,4675,4707,2289,2418,4478,42,041,011802
42,011803,0000066949113,00006669,2392,2392,0,2392,2298,94,6669,6669,0,0,6669,6593,6401,100,7,53,3,29,76,69,7,0,0,0,6669,84,6585,6669,3416,3253,6401,42,041,011803
42,011901,0000047004873,00004177,1747,1747,0,1747,1674,73,4177,4177,0,0,4177,4145,4006,72,11,39,0,17,32,27,4,1,0,0,4177,33,4144,4177,2047,2130,4006,42,041,011901
42,011902,0000014138831,00006020,2466,2466,0,2466,2365,101,6020,6020,0,0,6020,5944,5482,276,9,119,11,47,76,73,2,1,0,0,6020,118,5902,6020,2893,3127,5482,42,041,011902
42,012000,0000003367237,00004364,2039,2039,0,2039,1885,154,4364,4364,0,0,4364,4289,3696,456,5,86,0,46,75,67,4,1,3,0,4364,104,4260,4364,2057,2307,3696,42,041,012000
42,012100,0000001561375,00002183,1087,1087,0,1087,1004,83,2183,2183,0,0,2183,2131,1921,140,5,37,0,28,52,46,6,0,0,0,2183,50,2133,2183,1051,1132,1921,42,041,012100
42,012200,0000000483773,00001914,1141,1141,0,1141,974,167,1914,1914,0,0,1914,1889,1717,135,5,19,0,13,25,21,4,0,0,0,1914,60,1854,1914,975,939,1717,42,041,012200
42,012300,0000000743395,00002445,890,890,0,890,806,84,2445,2445,0,0,2445,2373,2012,304,6,37,2,12,72,63,7,0,2,0,2445,46,2399,2445,1000,1445,2012,42,041,012300
42,012400,0000007909807,00007064,2875,2875,0,2875,2757,118,7064,7064,0,0,7064,6985,6634,208,5,109,1,28,79,75,3,1,0,0,7064,92,6972,7064,3131,3933,6634,42,041,012400
42,012500,0000059896782,00009393,3965,3965,0,3965,3797,168,9393,9393,0,0,9393,9324,9111,56,6,108,8,35,69,63,2,4,0,0,9393,89,9304,9393,4505,4888,9111,42,041,012500
42,012600,0000072128077,00005471,2263,2263,0,2263,2120,143,5471,5471,0,0,5471,5436,5343,48,4,24,3,14,35,30,5,0,0,0,5471,50,5421,5471,2753,2718,5343,42,041,012600
42,012700,0000274026378,00008916,3377,3377,0,3377,3200,177,8916,8916,0,0,8916,8867,8764,33,15,29,2,24,49,35,14,0,0,0,8916,49,8867,8916,4459,4457,8764,42,041,012700
42,012800,0000137264076,00007432,2800,2800,0,2800,2704,96,7432,7432,0,0,7432,7397,7329,25,8,25,1,9,35,31,4,0,0,0,7432,32,7400,7432,3688,3744,7329,42,041,012800
42,012900,0000001147958,00001367,620,620,0,620,579,41,1367,1367,0,0,1367,1348,1327,12,3,0,0,6,19,19,0,0,0,0,1367,16,1351,1367,667,700,1327,42,041,012900
42,013000,0000208098966,00006597,2511,2511,0,2511,2390,121,6597,6597,0,0,6597,6559,6495,23,17,15,0,9,38,35,3,0,0,0,6597,40,6557,6597,3337,3260,6495,42,041,013000
42,013101,0000209397126,00007363,2652,2652,0,2652,2527,125,7363,7363,0,0,7363,7309,7215,34,18,26,2,14,54,52,1,0,1,0,7363,51,7312,7363,3680,3683,7215,42,041,013101
42,013102,0000006304659,00004379,879,879,0,879,803,76,4379,4379,0,0,4379,4333,4095,166,2,51,2,17,46,42,4,0,0,0,4379,51,4328,4379,2067,2312,4095,42,041,013102
42,013200,0000003507772,00004484,2102,2102,0,2102,1924,178,4484,4484,0,0,4484,4441,4193,169,6,49,1,23,43,43,0,0,0,0,4484,58,4426,4484,2061,2423,4193,42,041,013200
42,020100,0000002330998,00002968,2496,2496,0,2496,2036,460,2968,2968,0,0,2968,2876,1885,851,10,65,3,62,92,83,7,2,0,0,2968,136,2832,2968,1570,1398,1885,42,043,020100
42,020300,0000000378184,00001746,1319,1319,0,1319,1099,220,1746,1746,0,0,1746,1661,716,863,4,16,1,61,85,81,4,0,0,0,1746,132,1614,1746,894,852,716,42,043,020300
42,020400,0000000199219,00001656,1195,1195,0,1195,1030,165,1656,1656,0,0,1656,1592,1168,352,6,41,1,24,64,54,4,4,1,1,1656,48,1608,1656,864,792,1168,42,043,020400
42,020500,0000000710720,00003103,1774,1774,0,1774,1431,343,3103,3103,0,0,3103,3005,1319,1524,9,45,1,107,98,86,10,2,0,0,3103,202,2901,3103,1555,1548,1319,42,043,020500
42,020600,0000000374265,00001391,534,534,0,534,449,85,1391,1391,0,0,1391,1349,203,1055,8,30,0,53,42,34,5,3,0,0,1391,108,1283,1391,581,810,203,42,043,020600
42,020700,0000000524382,00002954,1181,1181,0,1181,941,240,2954,2954,0,0,2954,2850,227,2477,3,30,5,108,104,95,9,0,0,0,2954,181,2773,2954,1317,1637,227,42,043,020700
42,020800,0000000532310,00002704,1391,1391,0,1391,1193,198,2704,2704,0,0,2704,2604,917,1532,8,55,2,90,100,86,13,1,0,0,2704,177,2527,2704,1340,1364,917,42,043,020800
42,020900,0000002089499,00003636,1709,1709,0,1709,1521,188,3636,3636,0,0,3636,3557,1522,1878,17,33,1,106,79,69,10,0,0,0,3636,217,3419,3636,1660,1976,1522,42,043,020900
42,021100,0000006384376,00003069,1463,1463,0,1463,1205,258,3069,3069,0,0,3069,2975,313,2469,17,29,1,146,94,82,10,1,1,0,3069,266,2803,3069,1339,1730,313,42,043,021100
42,021200,0000000441478,00002372,1116,1116,0,1116,793,323,2372,2372,0,0,2372,2269,284,1806,2,39,0,138,103,100,2,1,0,0,2372,252,2120,2372,1161,1211,284,42,043,021200
42,021300,0000001214093,00006533,2795,2795,0,2795,2145,650,6533,6533,0,0,6533,6258,1797,3123,34,231,4,1069,275,256,19,0,0,0,6533,1666,4867,6533,3147,3386,1797,42,043,021300
42,021400,0000002278669,00005128,1941,1941,0,1941,1826,115,5128,5128,0,0,5128,4888,1016,2836,19,296,3,718,240,230,10,0,0,0,5128,1378,3750,5128,2178,2950,1016,42,043,021400
42,021500,0000000809928,00003479,1513,1513,0,1513,1353,160,3479,3479,0,0,3479,3351,984,2042,13,76,5,231,128,124,4,0,0,0,3479,414,3065,3479,1635,1844,984,42,043,021500
42,021600,0000000677650,00002645,1225,1225,0,1225,1030,195,2645,2645,0,0,2645,2525,418,1985,14,18,1,89,120,100,18,2,0,0,2645,188,2457,2645,1210,1435,418,42,043,021600
42,021700,0000002059620,00005566,2662,2662,0,2662,2509,153,5566,5566,0,0,5566,5409,2758,2048,19,380,7,197,157,143,13,1,0,0,5566,359,5207,5566,2555,3011,2758,42,043,021700
42,021800,0000002635763,00002194,980,980,0,980,936,44,2194,2194,0,0,2194,2161,1822,271,0,34,2,32,33,32,1,0,0,0,2194,70,2124,2194,1071,1123,1822,42,043,021800
42,021900,0000024000222,00010599,4466,4466,0,4466,4248,218,10599,10599,0,0,10599,10421,8128,1938,12,262,0,81,178,163,13,2,0,0,10599,190,10409,10599,5080,5519,8128,42,043,021900
42,022000,0000004295305,00005067,2373,2373,0,2373,2274,99,5067,5067,0,0,5067,4913,3146,1602,9,78,1,77,154,134,19,1,0,0,5067,148,4919,5067,2357,2710,3146,42,043,022000
42,022100,0000003797424,00004035,1774,1774,0,1774,1720,54,4035,4035,0,0,4035,3966,3391,430,3,105,1,36,69,67,2,0,0,0,4035,84,3951,4035,1790,2245,3391,42,043,022100
42,022200,0000001188044,00003044,1398,1398,0,1398,1307,91,3044,3044,0,0,3044,2931,2354,464,7,49,0,57,113,110,3,0,0,0,3044,140,2904,3044,1474,1570,2354,42,043,022200
42,022300,0000003509447,00005599,2673,2673,0,2673,2538,135,5599,5599,0,0,5599,5513,4806,513,9,116,3,66,86,81,5,0,0,0,5599,147,5452,5599,2576,3023,4806,42,043,022300
42,022401,0000007186734,00003320,1320,1320,0,1320,1275,45,3320,3320,0,0,3320,3289,3040,172,4,56,0,17,31,30,1,0,0,0,3320,43,3277,3320,1624,1696,3040,42,043,022401
42,022403,0000006254611,00006211,3156,3156,0,3156,2965,191,6211,6211,0,0,6211,6110,5072,591,7,320,3,117,101,91,10,0,0,0,6211,223,5988,6211,2969,3242,5072,42,043,022403
42,022501,0000018234051,00005274,1886,1886,0,1886,1833,53,5274,5274,0,0,5274,5238,4898,191,5,120,1,23,36,32,4,0,0,0,5274,76,5198,5274,2544,2730,4898,42,043,022501
42,022502,0000008891136,00005658,2283,2283,0,2283,2217,66,5658,5658,0,0,5658,5613,5414,107,5,80,1,6,45,44,1,0,0,0,5658,49,5609,5658,2726,2932,5414,42,043,022502
42,022601,0000008737949,00006814,2890,2890,0,2890,2800,90,6814,6814,0,0,6814,6745,6252,312,2,117,1,61,69,60,8,1,0,0,6814,111,6703,6814,3296,3518,6252,42,043,022601
42,022603,0000009116671,00007225,3498,3498,0,3498,3185,313,7225,7225,0,0,7225,7049,5186,1438,11,262,0,152,176,168,8,0,0,0,7225,304,6921,7225,3415,3810,5186,42,043,022603
42,022604,0000010850451,00004323,1900,1900,0,1900,1771,129,4323,4323,0,0,4323,4268,3763,356,3,123,1,22,55,51,0,4,0,0,4323,100,4223,4323,2070,2253,3763,42,043,022604
42,022700,0000006881646,00007764,3351,3351,0,3351,3251,100,7764,7764,0,0,7764,7611,6519,861,7,134,2,88,153,147,6,0,0,0,7764,248,7516,7764,3634,4130,6519,42,043,022700
42,022800,0000013512604,00005017,2107,2107,0,2107,2033,74,5017,5017,0,0,5017,4915,4325,381,9,87,4,109,102,83,19,0,0,0,5017,178,4839,5017,2424,2593,4325,42,043,022800
42,022900,0000012419723,00007958,2712,2712,0,2712,2551,161,7958,7958,0,0,7958,7752,5164,2239,12,142,5,190,206,193,12,1,0,0,7958,595,7363,7958,4161,3797,5164,42,043,022900
42,023000,0000001464293,00001872,898,898,0,898,868,30,1872,1872,0,0,1872,1840,1672,132,0,31,0,5,32,32,0,0,0,0,1872,50,1822,1872,888,984,1672,42,043,023000
42,023100,0000001083293,00001570,703,703,0,703,670,33,1570,1570,0,0,1570,1542,1390,100,2,24,0,26,28,27,1,0,0,0,1570,63,1507,1570,732,838,1390,42,043,023100
42,023300,0000001062230,00004230,1794,1794,0,1794,1627,167,4230,4230,0,0,4230,4087,2477,1453,6,38,2,111,143,132,11,0,0,0,4230,318,3912,4230,1985,2245,2477,42,043,023300
42,023400,0000003656035,00001628,739,739,0,739,685,54,1628,1628,0,0,1628,1564,1157,370,7,0,0,30,64,55,9,0,0,0,1628,120,1508,1628,741,887,1157,42,043,023400
42,023500,0000001872323,00002720,1373,1373,0,1373,1279,94,2720,2720,0,0,2720,2665,2356,223,3,24,0,59,55,52,3,0,0,0,2720,139,2581,2720,1309,1411,2356,42,043,023500
42,023600,0000031391880,00008149,3124,3124,0,3124,3003,121,8149,8149,0,0,8149,8063,7636,250,4,125,1,47,86,78,7,0,1,0,8149,156,7993,8149,3989,4160,7636,42,043,023600
42,023700,0000001036512,00001553,744,744,0,744,671,73,1553,1553,0,0,1553,1481,1098,327,15,3,1,37,72,70,0,2,0,0,1553,106,1447,1553,714,839,1098,42,043,023700
42,023800,0000001485900,00003845,2006,2006,0,2006,1789,217,3845,3845,0,0,3845,3761,3444,255,4,25,1,32,84,81,3,0,0,0,3845,128,3717,3845,1763,2082,3444,42,043,023800
42,023900,0000002754006,00003844,1637,1637,0,1637,1572,65,3844,3844,0,0,3844,3803,3662,96,6,21,2,16,41,37,2,1,1,0,3844,60,3784,3844,1766,2078,3662,42,043,023900
42,024001,0000059879040,00006187,2510,2510,0,2510,2399,111,6187,6187,0,0,6187,6118,6025,45,8,26,0,14,69,64,4,0,1,0,6187,59,6128,6187,3010,3177,6025,42,043,024001
42,024002,0000043341608,00002847,1069,1069,0,1069,1019,50,2847,2847,0,0,2847,2827,2779,23,0,11,4,10,20,17,3,0,0,0,2847,27,2820,2847,1436,1411,2779,42,043,024002
42,024101,0000017058888,00001641,907,907,0,907,790,117,1641,1641,0,0,1641,1601,1380,63,1,142,0,15,40,39,1,0,0,0,1641,43,1598,1641,784,857,1380,42,043,024101
42,024102,0000018395310,00003477,1498,1498,0,1498,1415,83,3477,3477,0,0,3477,3442,3250,84,1,98,0,9,35,31,4,0,0,0,3477,40,3437,3477,1645,1832,3250,42,043,024102
42,024103,0000025300323,00010114,3985,3985,0,3985,3808,177,10114,10114,0,0,10114,10034,9341,126,9,520,0,38,80,76,4,0,0,0,10114,120,9994,10114,4798,5316,9341,42,043,024103
42,024200,0000006352169,00002548,1337,1337,0,1337,1191,146,2548,2548,0,0,2548,2508,2403,51,2,35,4,13,40,36,4,0,0,0,2548,51,2497,2548,1216,1332,2403,42,043,024200
42,024300,0000003169094,00003493,1754,1754,0,1754,1657,97,3493,3493,0,0,3493,3435,3336,31,2,48,1,17,58,57,1,0,0,0,3493,43,3450,3493,1609,1884,3336,42,043,024300
42,024400,0000003492223,00004360,1953,1953,0,1953,1879,74,4360,4360,0,0,4360,4323,4230,14,1,46,3,29,37,28,8,1,0,0,4360,66,4294,4360,2124,2236,4230,42,043,024400
42,024502,0000103326084,00005322,2043,2043,0,2043,1966,77,5322,5322,0,0,5322,5264,5160,38,7,22,0,37,58,58,0,0,0,0,5322,101,5221,5322,2649,2673,5160,42,043,024502
42,024503,0000029155503,00004793,1772,1772,0,1772,1706,66,4793,4793,0,0,4793,4758,4679,16,14,45,0,4,35,32,2,0,1,0,4793,38,4755,4793,2402,2391,4679,42,043,024503
42,024600,0000060575283,00006505,2584,2584,0,2584,2502,82,6505,6505,0,0,6505,6483,6332,75,2,65,2,7,22,22,0,0,0,0,6505,35,6470,6505,3233,3272,6332,42,043,024600
42,024700,0000203111890,00005776,2400,2400,0,2400,2281,119,5776,5776,0,0,5776,5737,5661,17,8,25,1,25,39,33,1,0,5,0,5776,39,5737,5776,2904,2872,5661,42,043,024700
42,024800,0000288236624,00007625,3076,3076,0,3076,2917,159,7625,7625,0,0,7625,7583,7504,18,3,27,0,31,42,40,1,1,0,0,7625,60,7565,7625,3808,3817,7504,42,043,024800
42,024900,0000023391375,00002568,1220,1220,0,1220,1065,155,2568,2568,0,0,2568,2551,2536,4,4,3,0,4,17,17,0,0,0,0,2568,15,2553,2568,1263,1305,2536,42,043,024900
42,025000,0000029568251,00003105,1455,1455,0,1455,1286,169,3105,3105,0,0,3105,3080,3041,9,7,20,0,3,25,23,2,0,0,0,3105,11,3094,3105,1519,1586,3041,42,043,025000
42,025100,0000118919179,00003091,1224,1224,0,1224,1154,70,3091,3091,0,0,3091,3081,3063,13,2,0,0,3,10,10,0,0,0,0,3091,9,3082,3091,1587,1504,3063,42,043,025100
42,025200,0000049585402,00003391,1404,1404,0,1404,1335,69,3391,3391,0,0,3391,3367,3328,18,1,15,0,5,24,21,3,0,0,0,3391,34,3357,3391,1676,1715,3328,42,043,025200
42,025300,0000067294488,00003930,1528,1528,0,1528,1458,70,3930,3930,0,0,3930,3922,3887,16,5,10,0,4,8,8,0,0,0,0,3930,15,3915,3930,1910,2020,3887,42,043,025300
42,025400,0000002016787,00002562,1315,1315,0,1315,1213,102,2562,2562,0,0,2562,2554,2524,6,3,13,0,8,8,8,0,0,0,0,2562,28,2534,2562,1176,1386,2524,42,043,025400
42,400100,0000000177638,00000943,420,420,0,420,366,54,943,943,0,0,943,901,201,162,2,512,0,24,42,42,0,0,0,0,943,57,886,943,501,442,201,42,045,400100
42,400200,0000000655157,00003853,1188,1188,0,1188,1126,62,3853,3853,0,0,3853,3656,1124,567,5,1913,0,47,197,187,9,1,0,0,3853,53,3800,3853,1930,1923,1124,42,045,400200
42,400301,0000000768209,00006229,2731,2731,0,2731,2514,217,6229,6229,0,0,6229,6052,3588,1953,23,408,9,71,177,161,16,0,0,0,6229,180,6049,6229,2869,3360,3588,42,045,400301
42,400302,0000001094906,00003675,1489,1489,0,1489,1358,131,3675,3675,0,0,3675,3557,2565,854,6,112,0,20,118,109,7,2,0,0,3675,92,3583,3675,1712,1963,2565,42,045,400302
42,400401,0000000507690,00004765,1956,1956,0,1956,1830,126,4765,4765,0,0,4765,4612,2491,1118,6,954,1,42,153,141,10,2,0,0,4765,119,4646,4765,2340,2425,2491,42,045,400401
42,400402,0000000329637,00003992,1799,1799,0,1799,1662,137,3992,3992,0,0,3992,3826,2173,1092,5,534,3,19,166,154,11,1,0,0,3992,103,3889,3992,1909,2083,2173,42,045,400402
42,400500,0000001250139,00004140,1718,1718,0,1718,1624,94,4140,4140,0,0,4140,4005,3189,533,5,240,0,38,135,134,1,0,0,0,4140,113,4027,4140,2030,2110,3189,42,045,400500
42,400600,0000001398693,00005086,2154,2154,0,2154,2052,102,5086,5086,0,0,5086,5023,4629,186,8,173,1,26,63,55,7,0,1,0,5086,88,4998,5086,2415,2671,4629,42,045,400600
42,400700,0000001376392,00005114,1831,1831,0,1831,1737,94,5114,5114,0,0,5114,5030,3519,787,3,689,0,32,84,73,8,3,0,0,5114,91,5023,5114,2440,2674,3519,42,045,400700
42,400801,0000000362685,00001847,1109,1109,0,1109,970,139,1847,1847,0,0,1847,1777,518,837,0,409,0,13,70,62,8,0,0,0,1847,56,1791,1847,896,951,518,42,045,400801
42,400802,0000000958233,00003455,1392,1392,0,1392,1335,57,3455,3455,0,0,3455,3412,3138,165,2,87,0,20,43,42,1,0,0,0,3455,38,3417,3455,1678,1777,3138,42,045,400802
42,400900,0000000607793,00001681,583,583,0,583,573,10,1681,1681,0,0,1681,1671,1626,18,8,17,0,2,10,9,1,0,0,0,1681,12,1669,1681,813,868,1626,42,045,400900
42,401000,0000001029477,00001991,763,763,0,763,742,21,1991,1991,0,0,1991,1981,1927,25,1,19,3,6,10,8,2,0,0,0,1991,12,1979,1991,921,1070,1927,42,045,401000
42,401101,0000000435687,00002853,1282,1282,0,1282,1227,55,2853,2853,0,0,2853,2838,2780,33,4,14,0,7,15,14,1,0,0,0,2853,27,2826,2853,1346,1507,2780,42,045,401101
42,401103,0000000973293,00003557,1270,1270,0,1270,1236,34,3557,3557,0,0,3557,3528,3367,71,2,78,0,10,29,27,1,1,0,0,3557,37,3520,3557,1743,1814,3367,42,045,401103
42,401104,0000001202249,00004360,1721,1721,0,1721,1667,54,4360,4360,0,0,4360,4326,4185,72,4,65,0,0,34,33,1,0,0,0,4360,34,4326,4360,2096,2264,4185,42,045,401104
42,401200,0000001525396,00003780,1635,1635,0,1635,1586,49,3780,3780,0,0,3780,3763,3664,44,1,53,0,1,17,17,0,0,0,0,3780,26,3754,3780,1775,2005,3664,42,045,401200
42,401301,0000000495384,00002351,1329,1329,0,1329,1251,78,2351,2351,0,0,2351,2311,1414,174,5,693,0,25,40,35,5,0,0,0,2351,70,2281,2351,1109,1242,1414,42,045,401301
42,401302,0000000830529,00003197,1322,1322,0,1322,1277,45,3197,3197,0,0,3197,3169,3053,40,5,63,0,8,28,28,0,0,0,0,3197,23,3174,3197,1547,1650,3053,42,045,401302
42,401401,0000000530165,00002116,843,843,0,843,821,22,2116,2116,0,0,2116,2106,2017,20,0,67,0,2,10,9,1,0,0,0,2116,9,2107,2116,1003,1113,2017,42,045,401401
42,401402,0000000736799,00004048,1815,1815,0,1815,1744,71,4048,4048,0,0,4048,4014,3839,104,1,61,1,8,34,28,3,3,0,0,4048,45,4003,4048,1885,2163,3839,42,045,401402
42,401501,0000000700713,00003536,1446,1446,0,1446,1405,41,3536,3536,0,0,3536,3523,3484,17,3,15,0,4,13,13,0,0,0,0,3536,30,3506,3536,1642,1894,3484,42,045,401501
42,401502,0000001752514,00004329,2112,2112,0,2112,2008,104,4329,4329,0,0,4329,4259,3420,353,5,465,3,13,70,68,2,0,0,0,4329,60,4269,4329,2136,2193,3420,42,045,401502
42,401600,0000000859260,00001866,834,834,0,834,806,28,1866,1866,0,0,1866,1844,1512,207,0,117,0,8,22,22,0,0,0,0,1866,25,1841,1866,890,976,1512,42,045,401600
42,401700,0000000535064,00002586,1012,1012,0,1012,938,74,2586,2586,0,0,2586,2542,1842,530,2,156,0,12,44,39,5,0,0,0,2586,32,2554,2586,1294,1292,1842,42,045,401700
42,401800,0000000898093,00003732,1595,1595,0,1595,1473,122,3732,3732,0,0,3732,3622,2733,727,3,137,0,22,110,103,7,0,0,0,3732,53,3679,3732,1776,1956,2733,42,045,401800
42,401900,0000001320199,00004739,2035,2035,0,2035,1974,61,4739,4739,0,0,4739,4678,3942,579,6,134,1,16,61,60,1,0,0,0,4739,59,4680,4739,2231,2508,3942,42,045,401900
42,402000,0000000830505,00002573,1369,1369,0,1369,1277,92,2573,2573,0,0,2573,2482,1636,790,1,46,0,9,91,80,11,0,0,0,2573,51,2522,2573,1170,1403,1636,42,045,402000
42,402100,0000002507309,00005981,2321,2321,0,2321,2206,115,5981,5981,0,0,5981,5856,1081,4680,7,62,0,26,125,111,13,1,0,0,5981,69,5912,5981,2718,3263,1081,42,045,402100
42,402200,0000000888060,00002281,944,944,0,944,875,69,2281,2281,0,0,2281,2238,432,1758,10,28,0,10,43,40,3,0,0,0,2281,19,2262,2281,916,1365,432,42,045,402200
42,402300,0000000779348,00003500,1693,1693,0,1693,1615,78,3500,3500,0,0,3500,3415,317,3062,8,15,1,12,85,74,11,0,0,0,3500,32,3468,3500,1583,1917,317,42,045,402300
42,402400,0000000478952,00003535,1388,1388,0,1388,1173,215,3535,3535,0,0,3535,3431,848,2509,4,37,3,30,104,93,11,0,0,0,3535,49,3486,3535,1656,1879,848,42,045,402400
42,402500,0000000661182,00003398,1470,1470,0,1470,1231,239,3398,3398,0,0,3398,3332,616,2678,4,20,1,13,66,61,5,0,0,0,3398,23,3375,3398,1610,1788,616,42,045,402500
42,402600,0000000972760,00003366,1141,1141,0,1141,1001,140,3366,3366,0,0,3366,3326,2282,992,6,33,3,10,40,39,1,0,0,0,3366,26,3340,3366,1486,1880,2282,42,045,402600
42,402700,0000000661773,00002453,954,954,0,954,850,104,2453,2453,0,0,2453,2369,1046,1279,3,24,0,17,84,78,6,0,0,0,2453,40,2413,2453,1162,1291,1046,42,045,402700
42,402800,0000001969213,00005468,2246,2246,0,2246,2091,155,5468,5468,0,0,5468,5359,3886,1356,5,83,2,27,109,101,6,2,0,0,5468,58,5410,5468,2589,2879,3886,42,045,402800
42,402900,0000002215431,00003375,1379,1379,0,1379,1242,137,3375,3375,0,0,3375,3328,50,3257,4,3,1,13,47,37,6,1,3,0,3375,59,3316,3375,1501,1874,50,42,045,402900
42,403001,0000000516356,00003264,1280,1280,0,1280,1250,30,3264,3264,0,0,3264,3259,3247,7,0,3,0,2,5,5,0,0,0,0,3264,10,3254,3264,1534,1730,3247,42,045,403001
42,403002,0000000966102,00002983,1209,1209,0,1209,1178,31,2983,2983,0,0,2983,2970,2697,234,7,17,2,13,13,12,1,0,0,0,2983,17,2966,2983,1405,1578,2697,42,045,403002
42,403101,0000000860497,00003560,1378,1378,0,1378,1312,66,3560,3560,0,0,3560,3524,3330,113,5,60,0,16,36,34,2,0,0,0,3560,31,3529,3560,1731,1829,3330,42,045,403101
42,403103,0000000985904,00002686,1068,1068,0,1068,1007,61,2686,2686,0,0,2686,2658,2474,121,9,53,0,1,28,27,1,0,0,0,2686,18,2668,2686,1320,1366,2474,42,045,403103
42,403104,0000000398491,00002418,958,958,0,958,869,89,2418,2418,0,0,2418,2378,2162,173,11,27,1,4,40,36,2,2,0,0,2418,28,2390,2418,1155,1263,2162,42,045,403104
42,403200,0000001543894,00004313,1817,1817,0,1817,1751,66,4313,4313,0,0,4313,4282,4024,187,8,58,0,5,31,30,1,0,0,0,4313,40,4273,4313,2046,2267,4024,42,045,403200
42,403300,0000001613371,00006779,2883,2883,0,2883,2714,169,6779,6779,0,0,6779,6717,6387,198,4,102,0,26,62,59,3,0,0,0,6779,67,6712,6779,3308,3471,6387,42,045,403300
42,403401,0000001025542,00003114,1268,1268,0,1268,1200,68,3114,3114,0,0,3114,3078,2767,259,3,33,1,15,36,33,3,0,0,0,3114,47,3067,3114,1511,1603,2767,42,045,403401
42,403402,0000002482697,00003864,1361,1361,0,1361,1330,31,3864,3864,0,0,3864,3844,3784,18,3,33,1,5,20,15,5,0,0,0,3864,30,3834,3864,1903,1961,3784,42,045,403402
42,403501,0000001448745,00004581,1955,1955,0,1955,1860,95,4581,4581,0,0,4581,4524,4143,251,2,114,0,14,57,54,3,0,0,0,4581,57,4524,4581,2226,2355,4143,42,045,403501
42,403502,0000001074550,00002895,1243,1243,0,1243,1198,45,2895,2895,0,0,2895,2874,2756,50,1,64,1,2,21,20,1,0,0,0,2895,31,2864,2895,1323,1572,2756,42,045,403502
42,403601,0000001115004,00004067,1658,1658,0,1658,1595,63,4067,4067,0,0,4067,4046,3941,62,3,33,0,7,21,21,0,0,0,0,4067,30,4037,4067,1975,2092,3941,42,045,403601
42,403602,0000000956134,00001918,705,705,0,705,691,14,1918,1918,0,0,1918,1915,1898,4,0,9,0,4,3,3,0,0,0,0,1918,14,1904,1918,925,993,1898,42,045,403602
42,403701,0000012908315,00001895,791,791,0,791,721,70,1895,1895,0,0,1895,1870,1837,20,0,8,0,5,25,24,1,0,0,0,1895,33,1862,1895,952,943,1837,42,045,403701
42,403702,0000001956397,00002458,1085,1085,0,1085,1028,57,2458,2458,0,0,2458,2427,2389,15,3,11,0,9,31,31,0,0,0,0,2458,22,2436,2458,1221,1237,2389,42,045,403702
42,403800,0000001927648,00006594,2683,2683,0,2683,2577,106,6594,6594,0,0,6594,6534,6293,91,8,115,1,26,60,59,1,0,0,0,6594,60,6534,6594,3169,3425,6293,42,045,403800
42,403901,0000001216351,00003485,1681,1681,0,1681,1594,87,3485,3485,0,0,3485,3458,3315,41,1,86,2,13,27,22,5,0,0,0,3485,27,3458,3485,1600,1885,3315,42,045,403901
42,403902,0000001544922,00003711,1486,1486,0,1486,1421,65,3711,3711,0,0,3711,3686,3659,5,0,20,0,2,25,25,0,0,0,0,3711,9,3702,3711,1822,1889,3659,42,045,403902
42,404002,0000002822828,00007195,2872,2872,0,2872,2786,86,7195,7195,0,0,7195,7167,6935,142,1,86,0,3,28,27,1,0,0,0,7195,36,7159,7195,3464,3731,6935,42,045,404002
42,404003,0000000586200,00001825,945,945,0,945,887,58,1825,1825,0,0,1825,1804,1511,132,1,154,2,4,21,20,1,0,0,0,1825,27,1798,1825,866,959,1511,42,045,404003
42,404004,0000002318949,00006484,2466,2466,0,2466,2402,64,6484,6484,0,0,6484,6450,6301,66,3,62,5,13,34,34,0,0,0,0,6484,45,6439,6484,3129,3355,6301,42,045,404004
42,404101,0000002741689,00006443,2633,2633,0,2633,2592,41,6443,6443,0,0,6443,6385,5861,402,2,105,1,14,58,50,8,0,0,0,6443,44,6399,6443,2982,3461,5861,42,045,404101
42,404102,0000002318721,00005371,2244,2244,0,2244,2101,143,5371,5371,0,0,5371,5290,4634,555,13,56,6,26,81,78,3,0,0,0,5371,110,5261,5371,2670,2701,4634,42,045,404102
42,404103,0000002336989,00003473,1384,1384,0,1384,1353,31,3473,3473,0,0,3473,3449,3384,16,1,42,0,6,24,24,0,0,0,0,3473,20,3453,3473,1678,1795,3384,42,045,404103
42,404200,0000000347446,00000860,305,305,0,305,297,8,860,860,0,0,860,853,830,14,1,8,0,0,7,7,0,0,0,0,860,9,851,860,422,438,830,42,045,404200
42,404300,0000002688436,00002442,1035,1035,0,1035,964,71,2442,2442,0,0,2442,2409,2331,43,8,12,0,15,33,33,0,0,0,0,2442,45,2397,2442,1195,1247,2331,42,045,404300
42,404400,0000000557101,00001532,734,734,0,734,672,62,1532,1532,0,0,1532,1499,726,701,2,43,0,27,33,29,4,0,0,0,1532,38,1494,1532,736,796,726,42,045,404400
42,404500,0000001187063,00005037,2123,2123,0,2123,1875,248,5037,5037,0,0,5037,4923,1245,3545,6,38,3,86,114,100,14,0,0,0,5037,170,4867,5037,2279,2758,1245,42,045,404500
42,404600,0000000525933,00002415,976,976,0,976,885,91,2415,2415,0,0,2415,2357,865,1451,5,4,0,32,58,54,4,0,0,0,2415,72,2343,2415,1123,1292,865,42,045,404600
42,404700,0000000853176,00004067,1127,1127,0,1127,1051,76,4067,4067,0,0,4067,4026,1901,1944,17,76,0,88,41,38,2,1,0,0,4067,199,3868,4067,1951,2116,1901,42,045,404700
42,404800,0000000630107,00002625,998,998,0,998,814,184,2625,2625,0,0,2625,2558,482,1877,13,0,0,186,67,67,0,0,0,0,2625,352,2273,2625,1179,1446,482,42,045,404800
42,404900,0000000374108,00001730,698,698,0,698,548,150,1730,1730,0,0,1730,1701,137,1348,3,5,0,208,29,28,1,0,0,0,1730,294,1436,1730,827,903,137,42,045,404900
42,405000,0000001184094,00002413,1314,1314,0,1314,1046,268,2413,2413,0,0,2413,2369,173,2071,7,24,0,94,44,43,1,0,0,0,2413,184,2229,2413,1181,1232,173,42,045,405000
42,405100,0000000962513,00002312,999,999,0,999,895,104,2312,2312,0,0,2312,2301,33,2227,1,7,1,32,11,6,5,0,0,0,2312,56,2256,2312,988,1324,33,42,045,405100
42,405200,0000000762133,00002721,1130,1130,0,1130,1059,71,2721,2721,0,0,2721,2694,40,2611,1,0,0,42,27,24,3,0,0,0,2721,88,2633,2721,1120,1601,40,42,045,405200
42,405300,0000000732791,00003574,1405,1405,0,1405,1218,187,3574,3574,0,0,3574,3521,463,2957,0,12,0,89,53,52,1,0,0,0,3574,206,3368,3574,1606,1968,463,42,045,405300
42,405400,0000000702743,00002379,1075,1075,0,1075,842,233,2379,2379,0,0,2379,2352,402,1912,8,11,0,19,27,27,0,0,0,0,2379,50,2329,2379,1096,1283,402,42,045,405400
42,405600,0000002743846,00001640,313,313,0,313,232,81,1640,1640,0,0,1640,1635,248,1248,3,0,0,136,5,5,0,0,0,0,1640,141,1499,1640,1287,353,248,42,045,405600
42,405700,0000000739470,00002035,1023,1023,0,1023,807,216,2035,2035,0,0,2035,2007,222,1733,3,3,0,46,28,21,4,0,3,0,2035,62,1973,2035,928,1107,222,42,045,405700
42,405800,0000000595361,00002374,1061,1061,0,1061,870,191,2374,2374,0,0,2374,2355,43,2272,6,3,0,31,19,17,2,0,0,0,2374,74,2300,2374,1061,1313,43,42,045,405800
42,406100,0000000538779,00002267,918,918,0,918,869,49,2267,2267,0,0,2267,2249,2168,55,4,13,1,8,18,18,0,0,0,0,2267,40,2227,2267,1106,1161,2168,42,045,406100
42,406201,0000001642704,00002932,1204,1204,0,1204,1167,37,2932,2932,0,0,2932,2921,2838,44,2,24,0,13,11,11,0,0,0,0,2932,27,2905,2932,1356,1576,2838,42,045,406201
42,406202,0000002752548,00005053,2391,2391,0,2391,2309,82,5053,5053,0,0,5053,5017,4799,117,4,75,0,22,36,33,3,0,0,0,5053,63,4990,5053,2371,2682,4799,42,045,406202
42,406300,0000001736983,00002977,1216,1216,0,1216,1116,100,2977,2977,0,0,2977,2928,2299,586,9,10,0,24,49,48,1,0,0,0,2977,62,2915,2977,1402,1575,2299,42,045,406300
42,406401,0000000482423,00002935,1025,1025,0,1025,968,57,2935,2935,0,0,2935,2863,801,1990,12,27,1,32,72,66,6,0,0,0,2935,62,2873,2935,1387,1548,801,42,045,406401
42,406402,0000003129169,00001669,729,729,0,729,673,56,1669,1669,0,0,1669,1643,245,1386,0,0,0,12,26,19,7,0,0,0,1669,33,1636,1669,723,946,245,42,045,406402
42,406500,0000002733289,00001901,797,797,0,797,712,85,1901,1901,0,0,1901,1882,1684,175,1,3,0,19,19,19,0,0,0,0,1901,48,1853,1901,930,971,1684,42,045,406500
42,406600,0000002915464,00002314,1025,1025,0,1025,919,106,2314,2314,0,0,2314,2271,2116,123,2,14,0,16,43,39,4,0,0,0,2314,41,2273,2314,1122,1192,2116,42,045,406600
42,406700,0000002884327,00003591,1356,1356,0,1356,1278,78,3591,3591,0,0,3591,3558,3460,73,5,14,0,6,33,32,1,0,0,0,3591,49,3542,3591,1752,1839,3460,42,045,406700
42,406801,0000006222086,00004431,1737,1737,0,1737,1678,59,4431,4431,0,0,4431,4359,3708,542,4,89,0,16,72,62,10,0,0,0,4431,79,4352,4431,2119,2312,3708,42,045,406801
42,406802,0000004980833,00004611,1815,1815,0,1815,1736,79,4611,4611,0,0,4611,4563,3928,588,12,25,1,9,48,45,3,0,0,0,4611,35,4576,4611,2234,2377,3928,42,045,406802
42,406803,0000006188416,00007800,3153,3153,0,3153,3086,67,7800,7800,0,0,7800,7728,6848,614,14,226,0,26,72,67,5,0,0,0,7800,82,7718,7800,3665,4135,6848,42,045,406803
42,406902,0000004838399,00006278,2333,2333,0,2333,2272,61,6278,6278,0,0,6278,6225,6083,58,1,50,2,31,53,53,0,0,0,0,6278,80,6198,6278,3073,3205,6083,42,045,406902
42,406903,0000003248462,00005424,1972,1972,0,1972,1943,29,5424,5424,0,0,5424,5399,5311,47,2,34,1,4,25,23,2,0,0,0,5424,41,5383,5424,2619,2805,5311,42,045,406903
42,406904,0000006764118,00004501,1673,1673,0,1673,1623,50,4501,4501,0,0,4501,4457,4268,134,2,43,0,10,44,38,5,1,0,0,4501,42,4459,4501,2037,2464,4268,42,045,406904
42,407000,0000005423504,00002481,1117,1117,0,1117,1056,61,2481,2481,0,0,2481,2440,2324,57,2,47,3,7,41,41,0,0,0,0,2481,32,2449,2481,1171,1310,2324,42,045,407000
42,407101,0000007396552,00003619,1370,1370,0,1370,1354,16,3619,3619,0,0,3619,3597,3443,62,0,85,1,6,22,21,1,0,0,0,3619,25,3594,3619,1725,1894,3443,42,045,407101
42,407102,0000004195975,00003184,1143,1143,0,1143,1126,17,3184,3184,0,0,3184,3163,3090,45,1,21,2,4,21,15,4,2,0,0,3184,40,3144,3184,1557,1627,3090,42,045,407102
42,407201,0000016876545,00005436,1726,1726,0,1726,1684,42,5436,5436,0,0,5436,5406,5084,201,4,111,0,6,30,28,2,0,0,0,5436,31,5405,5436,2173,3263,5084,42,045,407201
42,407202,0000006416815,00003825,1402,1402,0,1402,1360,42,3825,3825,0,0,3825,3782,3528,187,0,58,0,9,43,38,5,0,0,0,3825,43,3782,3825,1894,1931,3528,42,045,407202
42,407300,0000001834397,00000944,351,351,0,351,347,4,944,944,0,0,944,935,900,15,1,16,0,3,9,9,0,0,0,0,944,21,923,944,468,476,900,42,045,407300
42,407401,0000004553952,00003792,1392,1392,0,1392,1370,22,3792,3792,0,0,3792,3747,3056,576,2,102,0,11,45,41,4,0,0,0,3792,35,3757,3792,1818,1974,3056,42,045,407401
42,407403,0000004184671,00006847,2625,2625,0,2625,2554,71,6847,6847,0,0,6847,6773,6417,169,7,162,0,18,74,68,6,0,0,0,6847,83,6764,6847,3243,3604,6417,42,045,407403
42,407404,0000003456604,00002817,1108,1108,0,1108,1083,25,2817,2817,0,0,2817,2794,2648,79,4,51,5,7,23,22,1,0,0,0,2817,34,2783,2817,1343,1474,2648,42,045,407404
42,407501,0000000854657,00002288,1221,1221,0,1221,1163,58,2288,2288,0,0,2288,2254,1966,241,3,34,0,10,34,31,3,0,0,0,2288,43,2245,2288,1047,1241,1966,42,045,407501
42,407502,0000001082135,00003245,1745,1745,0,1745,1619,126,3245,3245,0,0,3245,3172,2517,546,5,77,1,26,73,63,9,1,0,0,3245,61,3184,3245,1478,1767,2517,42,045,407502
42,407600,0000003582713,00006170,2064,2064,0,2064,1993,71,6170,6170,0,0,6170,6012,5298,291,15,339,3,66,158,143,15,0,0,0,6170,208,5962,6170,2917,3253,5298,42,045,407600
42,407700,0000000937280,00002715,1209,1209,0,1209,1145,64,2715,2715,0,0,2715,2678,1897,664,2,106,0,9,37,30,7,0,0,0,2715,31,2684,2715,1276,1439,1897,42,045,407700
42,407801,0000004435193,00004163,1628,1628,0,1628,1565,63,4163,4163,0,0,4163,4145,4080,15,0,46,0,4,18,16,2,0,0,0,4163,12,4151,4163,1972,2191,4080,42,045,407801
42,407802,0000004785526,00006410,2270,2270,0,2270,2246,24,6410,6410,0,0,6410,6368,6106,48,1,204,0,9,42,42,0,0,0,0,6410,71,6339,6410,3083,3327,6106,42,045,407802
42,407803,0000002477274,00005287,1937,1937,0,1937,1911,26,5287,5287,0,0,5287,5259,5172,17,6,57,0,7,28,26,2,0,0,0,5287,20,5267,5287,2529,2758,5172,42,045,407803
42,407804,0000002155690,00004358,1600,1600,0,1600,1577,23,4358,4358,0,0,4358,4344,4281,7,1,48,3,4,14,11,3,0,0,0,4358,20,4338,4358,2104,2254,4281,42,045,407804
42,407805,0000001054647,00001653,613,613,0,613,585,28,1653,1653,0,0,1653,1645,1576,17,3,49,0,0,8,8,0,0,0,0,1653,6,1647,1653,793,860,1576,42,045,407805
42,407806,0000001562941,00001806,752,752,0,752,734,18,1806,1806,0,0,1806,1788,1653,66,2,62,0,5,18,16,2,0,0,0,1806,17,1789,1806,851,955,1653,42,045,407806
42,407901,0000009040072,00004155,1455,1455,0,1455,1429,26,4155,4155,0,0,4155,4135,3988,49,4,89,0,5,20,20,0,0,0,0,4155,27,4128,4155,2060,2095,3988,42,045,407901
42,407902,0000003121356,00002735,1190,1190,0,1190,1142,48,2735,2735,0,0,2735,2714,2499,158,3,44,0,10,21,20,1,0,0,0,2735,42,2693,2735,1360,1375,2499,42,045,407902
42,407903,0000002319082,00003619,1654,1654,0,1654,1504,150,3619,3619,0,0,3619,3571,3163,203,1,188,0,16,48,45,3,0,0,0,3619,43,3576,3619,1740,1879,3163,42,045,407903
42,408001,0000005935513,00006092,2231,2231,0,2231,2202,29,6092,6092,0,0,6092,6059,5759,25,3,265,0,7,33,33,0,0,0,0,6092,31,6061,6092,2943,3149,5759,42,045,408001
42,408002,0000009564648,00004416,1734,1734,0,1734,1676,58,4416,4416,0,0,4416,4382,4092,65,9,206,0,10,34,34,0,0,0,0,4416,52,4364,4416,1957,2459,4092,42,045,408002
42,408101,0000004434516,00005163,1731,1731,0,1731,1704,27,5163,5163,0,0,5163,5132,4862,76,1,192,0,1,31,31,0,0,0,0,5163,25,5138,5163,2358,2805,4862,42,045,408101
42,408102,0000002612597,00003532,1355,1355,0,1355,1331,24,3532,3532,0,0,3532,3517,3295,19,1,199,0,3,15,15,0,0,0,0,3532,21,3511,3532,1713,1819,3295,42,045,408102
42,408103,0000003882232,00004534,1746,1746,0,1746,1710,36,4534,4534,0,0,4534,4507,3972,76,7,445,0,7,27,26,1,0,0,0,4534,27,4507,4534,2230,2304,3972,42,045,408103
42,408300,0000004003093,00003993,1475,1475,0,1475,1440,35,3993,3993,0,0,3993,3933,3419,383,1,119,0,11,60,49,9,2,0,0,3993,66,3927,3993,1819,2174,3419,42,045,408300
42,408400,0000004527001,00001984,949,949,0,949,926,23,1984,1984,0,0,1984,1978,1895,30,1,52,0,0,6,6,0,0,0,0,1984,16,1968,1984,861,1123,1895,42,045,408400
42,408500,0000001890472,00004004,1572,1572,0,1572,1553,19,4004,4004,0,0,4004,3975,3617,45,1,301,0,11,29,29,0,0,0,0,4004,26,3978,4004,1920,2084,3617,42,045,408500
42,408600,0000001600272,00003555,1340,1340,0,1340,1324,16,3555,3555,0,0,3555,3537,3425,25,12,65,2,8,18,13,5,0,0,0,3555,16,3539,3555,1738,1817,3425,42,045,408600
42,408700,0000002120296,00005017,1817,1817,0,1817,1786,31,5017,5017,0,0,5017,4957,4722,79,14,135,2,5,60,60,0,0,0,0,5017,41,4976,5017,2395,2622,4722,42,045,408700
42,408800,0000001645226,00005013,2088,2088,0,2088,2033,55,5013,5013,0,0,5013,4952,4579,253,4,95,0,21,61,56,5,0,0,0,5013,69,4944,5013,2396,2617,4579,42,045,408800
42,408900,0000001507112,00003054,1105,1105,0,1105,1087,18,3054,3054,0,0,3054,3033,2915,41,0,74,0,3,21,21,0,0,0,0,3054,24,3030,3054,1478,1576,2915,42,045,408900
42,409000,0000001209292,00003651,1366,1366,0,1366,1341,25,3651,3651,0,0,3651,3610,3459,59,2,80,0,10,41,39,2,0,0,0,3651,43,3608,3651,1725,1926,3459,42,045,409000
42,409100,0000001358090,00004221,1511,1511,0,1511,1484,27,4221,4221,0,0,4221,4199,4089,13,1,81,2,13,22,19,3,0,0,0,4221,38,4183,4221,2028,2193,4089,42,045,409100
42,409200,0000001184317,00004136,1518,1518,0,1518,1495,23,4136,4136,0,0,4136,4123,4009,17,4,87,0,6,13,8,5,0,0,0,4136,32,4104,4136,1985,2151,4009,42,045,409200
42,409300,0000001671702,00002388,911,911,0,911,895,16,2388,2388,0,0,2388,2366,2280,11,3,70,0,2,22,19,3,0,0,0,2388,18,2370,2388,1147,1241,2280,42,045,409300
42,409400,0000001196342,00002845,1009,1009,0,1009,994,15,2845,2845,0,0,2845,2829,2698,23,3,101,0,4,16,13,3,0,0,0,2845,15,2830,2845,1308,1537,2698,42,045,409400
42,409500,0000002014282,00004637,1717,1717,0,1717,1703,14,4637,4637,0,0,4637,4612,4478,49,3,78,0,4,25,21,3,1,0,0,4637,27,4610,4637,2251,2386,4478,42,045,409500
42,409601,0000005836414,00004942,1972,1972,0,1972,1940,32,4942,4942,0,0,4942,4893,4149,147,10,564,0,23,49,34,1,13,1,0,4942,64,4878,4942,2211,2731,4149,42,045,409601
42,409602,0000001055168,00003307,1801,1801,0,1801,1713,88,3307,3307,0,0,3307,3246,2783,191,2,253,0,17,61,55,4,2,0,0,3307,61,3246,3307,1472,1835,2783,42,045,409602
42,409701,0000016243857,00006652,1996,1996,0,1996,1941,55,6652,6652,0,0,6652,6603,6080,91,2,395,3,32,49,45,4,0,0,0,6652,96,6556,6652,3214,3438,6080,42,045,409701
42,409702,0000000746488,00003352,175,175,0,175,171,4,3352,3352,0,0,3352,3304,3024,99,1,126,0,54,48,45,2,1,0,0,3352,156,3196,3352,1667,1685,3024,42,045,409702
42,409802,0000005954452,00005449,1658,1658,0,1658,1571,87,5449,5449,0,0,5449,5393,5024,173,6,146,2,42,56,55,1,0,0,0,5449,139,5310,5449,2432,3017,5024,42,045,409802
42,409803,0000005798263,00007176,3129,3129,0,3129,3011,118,7176,7176,0,0,7176,7135,6592,252,3,266,0,22,41,30,7,4,0,0,7176,112,7064,7176,3388,3788,6592,42,045,409803
42,409902,0000007931066,00004321,1796,1796,0,1796,1739,57,4321,4321,0,0,4321,4300,4150,27,7,112,0,4,21,18,3,0,0,0,4321,30,4291,4321,1987,2334,4150,42,045,409902
42,409903,0000003629685,00004070,1663,1663,0,1663,1626,37,4070,4070,0,0,4070,4033,3914,21,1,91,0,6,37,35,2,0,0,0,4070,19,4051,4070,1920,2150,3914,42,045,409903
42,409904,0000014427653,00003309,1231,1231,0,1231,1184,47,3309,3309,0,0,3309,3287,3187,29,0,66,0,5,22,22,0,0,0,0,3309,32,3277,3309,1598,1711,3187,42,045,409904
42,410000,0000025258907,00003918,1515,1515,0,1515,1447,68,3918,3918,0,0,3918,3868,3549,192,5,107,0,15,50,46,3,0,0,1,3918,53,3865,3918,1900,2018,3549,42,045,410000
42,410100,0000023886839,00007093,1387,1387,0,1387,1360,27,7093,7093,0,0,7093,7044,4588,2205,8,90,4,149,49,39,9,1,0,0,7093,193,6900,7093,4494,2599,4588,42,045,410100
42,410200,0000022540360,00003170,1338,1338,0,1338,1314,24,3170,3170,0,0,3170,3159,3020,34,2,88,0,15,11,10,1,0,0,0,3170,45,3125,3170,1522,1648,3020,42,045,410200
42,410301,0000017805081,00004882,1650,1650,0,1650,1619,31,4882,4882,0,0,4882,4843,4676,68,2,89,0,8,39,38,1,0,0,0,4882,29,4853,4882,2408,2474,4676,42,045,410301
42,410302,0000017610041,00005051,1901,1901,0,1901,1765,136,5051,5051,0,0,5051,5020,4838,33,7,134,0,8,31,29,2,0,0,0,5051,36,5015,5051,2448,2603,4838,42,045,410302
42,410400,0000014686714,00006421,2017,2017,0,2017,1984,33,6421,6421,0,0,6421,6383,6064,140,2,155,1,21,38,36,1,1,0,0,6421,124,6297,6421,3201,3220,6064,42,045,410400
42,990100,0000376658112,00001721,1175,1175,0,1175,687,488,1721,1721,0,0,1721,1718,1713,1,2,0,0,2,3,3,0,0,0,0,1721,5,1716,1721,899,822,1713,42,047,990100
42,990200,0000723533948,00003666,2925,2925,0,2925,1434,1491,3666,3666,0,0,3666,3651,3637,5,3,3,0,3,15,15,0,0,0,0,3666,9,3657,3666,1858,1808,3637,42,047,990200
42,990400,0000006902476,00004591,2089,2089,0,2089,1927,162,4591,4591,0,0,4591,4574,4524,8,2,32,0,8,17,17,0,0,0,0,4591,24,4567,4591,2190,2401,4524,42,047,990400
42,990500,0000007859389,00003003,1435,1435,0,1435,1292,143,3003,3003,0,0,3003,2993,2968,1,9,11,1,3,10,10,0,0,0,0,3003,39,2964,3003,1477,1526,2968,42,047,990500
42,990900,0000452178353,00002321,2062,2062,0,2062,977,1085,2321,2321,0,0,2321,2315,2304,1,1,9,0,0,6,6,0,0,0,0,2321,16,2305,2321,1143,1178,2304,42,047,990900
42,991000,0000321821259,00005308,2337,2337,0,2337,2084,253,5308,5308,0,0,5308,5296,5279,3,5,6,1,2,12,11,1,0,0,0,5308,5,5303,5308,2725,2583,5279,42,047,991000
42,991100,0000092670903,00006278,2707,2707,0,2707,2530,177,6278,6278,0,0,6278,6263,6200,12,4,34,1,12,15,15,0,0,0,0,6278,28,6250,6278,2963,3315,6200,42,047,991100
42,991200,0000106992887,00002259,930,930,0,930,842,88,2259,2259,0,0,2259,2249,2220,9,5,2,11,2,10,6,4,0,0,0,2259,4,2255,2259,1169,1090,2220,42,047,991200
42,991300,0000057581238,00005965,2455,2455,0,2455,2351,104,5965,5965,0,0,5965,5945,5901,12,2,25,1,4,20,20,0,0,0,0,5965,12,5953,5965,2957,3008,5901,42,047,991300
42,000000,0000000000000,00000000,0,0,0,0,0,0,0,0,0,0,0,0,0,0,0,0,0,0,0,0,0,0,0,0,0,0,0,0,0,0,0,42,049,000000
42,000100,0000000759747,00002481,1235,1235,0,1235,1073,162,2481,2481,0,0,2481,2436,2144,266,7,14,0,5,45,38,7,0,0,0,2481,38,2443,2481,1067,1414,2144,42,049,000100
42,000200,0000002723576,00004133,2037,2037,0,2037,1928,109,4133,4133,0,0,4133,4097,4005,49,3,10,2,28,36,36,0,0,0,0,4133,93,4040,4133,1839,2294,4005,42,049,000200
42,000300,0000001656153,00003610,1721,1721,0,1721,1471,250,3610,3610,0,0,3610,3483,2336,1018,18,27,0,84,127,118,9,0,0,0,3610,178,3432,3610,1831,1779,2336,42,049,000300
42,000400,0000002404064,00002909,1220,1220,0,1220,1028,192,2909,2909,0,0,2909,2859,2255,525,6,39,2,32,50,46,4,0,0,0,2909,116,2793,2909,1505,1404,2255,42,049,000400
42,000500,0000000959646,00003225,1476,1476,0,1476,1290,186,3225,3225,0,0,3225,3101,2609,394,4,6,0,88,124,119,5,0,0,0,3225,193,3032,3225,1531,1694,2609,42,049,000500
42,000600,0000002671167,00003283,1492,1492,0,1492,1333,159,3283,3283,0,0,3283,3145,2368,573,7,10,1,186,138,124,14,0,0,0,3283,313,2970,3283,1505,1778,2368,42,049,000600
42,000700,0000000730247,00002983,1248,1248,0,1248,1084,164,2983,2983,0,0,2983,2884,2053,658,15,12,0,146,99,98,1,0,0,0,2983,276,2707,2983,1428,1555,2053,42,049,000700
42,000800,0000000755730,00003441,1552,1552,0,1552,1305,247,3441,3441,0,0,3441,3267,2249,898,16,49,0,55,174,169,5,0,0,0,3441,268,3173,3441,1748,1693,2249,42,049,000800
42,000900,0000000964925,00004948,2606,2606,0,2606,2265,341,4948,4948,0,0,4948,4806,4235,452,2,60,2,55,142,136,6,0,0,0,4948,148,4800,4948,2431,2517,4235,42,049,000900
42,001000,0000001255387,00003519,1718,1718,0,1718,1511,207,3519,3519,0,0,3519,3422,3006,366,6,28,1,15,97,93,3,0,1,0,3519,92,3427,3519,1712,1807,3006,42,049,001000
42,001100,0000003152052,00002832,1147,1147,0,1147,1092,55,2832,2832,0,0,2832,2796,2438,245,5,24,0,84,36,35,1,0,0,0,2832,151,2681,2832,1353,1479,2438,42,049,001100
42,001200,0000001624142,00002728,1293,1293,0,1293,1043,250,2728,2728,0,0,2728,2579,1878,526,13,18,0,144,149,144,4,1,0,0,2728,356,2372,2728,1364,1364,1878,42,049,001200
42,001300,0000001021136,00001830,734,734,0,734,634,100,1830,1830,0,0,1830,1766,585,1086,15,23,4,53,64,63,1,0,0,0,1830,183,1647,1830,835,995,585,42,049,001300
42,001400,0000000844667,00001804,627,627,0,627,542,85,1804,1804,0,0,1804,1758,1210,457,12,5,0,74,46,45,1,0,0,0,1804,191,1613,1804,1104,700,1210,42,049,001400
42,001500,0000002542392,00002794,1023,1023,0,1023,907,116,2794,2794,0,0,2794,2633,954,1419,8,44,0,208,161,156,5,0,0,0,2794,369,2425,2794,1321,1473,954,42,049,001500
42,001600,0000003553035,00004267,1675,1675,0,1675,1587,88,4267,4267,0,0,4267,4140,3029,949,8,55,5,94,127,125,2,0,0,0,4267,199,4068,4267,2061,2206,3029,42,049,001600
42,001700,0000000580842,00003024,1205,1205,0,1205,1032,173,3024,3024,0,0,3024,2888,1752,976,15,19,0,126,136,133,3,0,0,0,3024,257,2767,3024,1452,1572,1752,42,049,001700
42,001800,0000000617899,00002576,1027,1027,0,1027,858,169,2576,2576,0,0,2576,2469,806,1502,6,14,9,132,107,98,9,0,0,0,2576,217,2359,2576,1214,1362,806,42,049,001800
42,001900,0000000555632,00002204,1057,1057,0,1057,948,109,2204,2204,0,0,2204,2141,1902,191,5,7,0,36,63,63,0,0,0,0,2204,89,2115,2204,916,1288,1902,42,049,001900
42,002000,0000001122131,00003536,1507,1507,0,1507,1394,113,3536,3536,0,0,3536,3472,3246,163,9,22,2,30,64,63,1,0,0,0,3536,118,3418,3536,1745,1791,3246,42,049,002000
42,002100,0000002084500,00003755,1679,1679,0,1679,1648,31,3755,3755,0,0,3755,3741,3666,30,6,17,0,22,14,14,0,0,0,0,3755,42,3713,3755,1777,1978,3666,42,049,002100
42,002200,0000001143157,00003968,1709,1709,0,1709,1641,68,3968,3968,0,0,3968,3930,3825,43,7,18,0,37,38,36,2,0,0,0,3968,86,3882,3968,1873,2095,3825,42,049,002200
42,002300,0000000818389,00002771,1230,1230,0,1230,1173,57,2771,2771,0,0,2771,2733,2644,42,10,20,0,17,38,29,9,0,0,0,2771,54,2717,2771,1310,1461,2644,42,049,002300
42,002400,0000001208840,00003319,1495,1495,0,1495,1367,128,3319,3319,0,0,3319,3265,3043,163,6,7,5,41,54,51,3,0,0,0,3319,61,3258,3319,1596,1723,3043,42,049,002400
42,002500,0000000672628,00002561,1031,1031,0,1031,952,79,2561,2561,0,0,2561,2523,2121,350,5,15,0,32,38,35,3,0,0,0,2561,72,2489,2561,1239,1322,2121,42,049,002500
42,002600,0000001195563,00004389,1643,1643,0,1643,1558,85,4389,4389,0,0,4389,4338,3948,300,2,16,1,71,51,50,1,0,0,0,4389,111,4278,4389,1999,2390,3948,42,049,002600
42,002700,0000004056300,00006854,2948,2948,0,2948,2868,80,6854,6854,0,0,6854,6795,6161,508,6,88,2,30,59,59,0,0,0,0,6854,115,6739,6854,3272,3582,6161,42,049,002700
42,002800,0000002852559,00006810,2483,2483,0,2483,2391,92,6810,6810,0,0,6810,6750,6415,265,5,52,2,11,60,57,3,0,0,0,6810,68,6742,6810,3089,3721,6415,42,049,002800
42,002900,0000002529712,00002916,1241,1241,0,1241,1198,43,2916,2916,0,0,2916,2904,2836,43,1,23,1,0,12,12,0,0,0,0,2916,15,2901,2916,1373,1543,2836,42,049,002900
42,003000,0000002184494,00004218,1878,1878,0,1878,1801,77,4218,4218,0,0,4218,4166,3804,266,4,34,3,55,52,48,3,1,0,0,4218,102,4116,4218,1851,2367,3804,42,049,003000
42,010101,0000097628864,00003378,1462,1462,0,1462,1253,209,3378,3378,0,0,3378,3352,3306,21,7,9,0,9,26,23,3,0,0,0,3378,19,3359,3378,1704,1674,3306,42,049,010101
42,010103,0000110378832,00002010,762,762,0,762,732,30,2010,2010,0,0,2010,1995,1966,13,11,3,0,2,15,15,0,0,0,0,2010,14,1996,2010,1030,980,1966,42,049,010103
42,010104,0000092333418,00002400,921,921,0,921,869,52,2400,2400,0,0,2400,2379,2363,5,4,2,0,5,21,16,4,1,0,0,2400,14,2386,2400,1212,1188,2363,42,049,010104
42,010107,0000002755042,00001607,695,695,0,695,655,40,1607,1607,0,0,1607,1602,1581,8,5,6,0,2,5,5,0,0,0,0,1607,19,1588,1607,749,858,1581,42,049,010107
42,010109,0000001799901,00001898,9,9,0,9,8,1,1898,1898,0,0,1898,1895,902,975,7,11,0,0,3,3,0,0,0,0,1898,188,1710,1898,1891,7,902,42,049,010109
42,010201,0000010745842,00005975,2345,2345,0,2345,2251,94,5975,5975,0,0,5975,5957,5915,12,9,10,0,11,18,15,3,0,0,0,5975,36,5939,5975,2847,3128,5915,42,049,010201
42,010202,0000090809844,00005607,2257,2257,0,2257,2127,130,5607,5607,0,0,5607,5581,5542,12,8,10,2,7,26,26,0,0,0,0,5607,19,5588,5607,2781,2826,5542,42,049,010202
42,010301,0000096324207,00005008,1875,1875,0,1875,1799,76,5008,5008,0,0,5008,4986,4923,27,18,5,0,13,22,21,1,0,0,0,5008,35,4973,5008,2514,2494,4923,42,049,010301
42,010303,0000055954389,00005269,1946,1946,0,1946,1859,87,5269,5269,0,0,5269,5238,5197,22,4,9,0,6,31,30,1,0,0,0,5269,38,5231,5269,2498,2771,5197,42,049,010303
42,010304,0000019574574,00004871,1765,1765,0,1765,1676,89,4871,4871,0,0,4871,4848,4756,32,4,48,0,8,23,23,0,0,0,0,4871,31,4840,4871,2352,2519,4756,42,049,010304
42,010400,0000007643593,00005170,2152,2152,0,2152,2025,127,5170,5170,0,0,5170,5143,5038,24,10,57,0,14,27,27,0,0,0,0,5170,65,5105,5170,2495,2675,5038,42,049,010400
42,010500,0000004553953,00004760,2473,2473,0,2473,2216,257,4760,4760,0,0,4760,4736,4653,36,9,17,0,21,24,23,1,0,0,0,4760,60,4700,4760,2277,2483,4653,42,049,010500
42,010600,0000010924867,00001547,840,840,0,840,756,84,1547,1547,0,0,1547,1539,1482,17,2,20,0,18,8,6,2,0,0,0,1547,26,1521,1547,703,844,1482,42,049,010600
42,010700,0000002757395,00004163,1864,1864,0,1864,1788,76,4163,4163,0,0,4163,4123,4017,50,1,48,0,7,40,40,0,0,0,0,4163,64,4099,4163,2016,2147,4017,42,049,010700
42,010800,0000003966201,00003700,1570,1570,0,1570,1509,61,3700,3700,0,0,3700,3681,3626,18,4,20,1,12,19,18,1,0,0,0,3700,36,3664,3700,1818,1882,3626,42,049,010800
42,010902,0000005042552,00004451,1928,1928,0,1928,1819,109,4451,4451,0,0,4451,4418,4299,49,3,51,1,15,33,25,1,2,5,0,4451,55,4396,4451,2129,2322,4299,42,049,010902
42,010903,0000009085988,00006237,2426,2426,0,2426,2330,96,6237,6237,0,0,6237,6193,5939,57,1,189,0,7,44,41,3,0,0,0,6237,34,6203,6237,3060,3177,5939,42,049,010903
42,010904,0000011449933,00003289,1152,1152,0,1152,1094,58,3289,3289,0,0,3289,3280,3211,15,1,51,0,2,9,9,0,0,0,0,3289,14,3275,3289,1646,1643,3211,42,049,010904
42,011001,0000005230276,00006753,3091,3091,0,3091,2984,107,6753,6753,0,0,6753,6717,6451,133,3,94,5,31,36,33,3,0,0,0,6753,70,6683,6753,3339,3414,6451,42,049,011001
42,011002,0000006381568,00003707,1704,1704,0,1704,1631,73,3707,3707,0,0,3707,3689,3599,31,5,45,0,9,18,17,1,0,0,0,3707,20,3687,3707,1698,2009,3599,42,049,011002
42,011101,0000009031871,00004900,1887,1887,0,1887,1811,76,4900,4900,0,0,4900,4851,4677,72,2,83,0,17,49,47,2,0,0,0,4900,54,4846,4900,2385,2515,4677,42,049,011101
42,011102,0000007910863,00003481,1316,1316,0,1316,1270,46,3481,3481,0,0,3481,3465,3367,69,4,23,0,2,16,16,0,0,0,0,3481,21,3460,3481,1591,1890,3367,42,049,011102
42,011201,0000097202058,00004768,1784,1784,0,1784,1724,60,4768,4768,0,0,4768,4753,4729,4,9,3,0,8,15,9,6,0,0,0,4768,12,4756,4768,2426,2342,4729,42,049,011201
42,011202,0000061841950,00005529,2212,2212,0,2212,2110,102,5529,5529,0,0,5529,5496,5432,31,7,13,0,13,33,28,5,0,0,0,5529,19,5510,5529,2749,2780,5432,42,049,011202
42,011300,0000001384700,00003617,1512,1512,0,1512,1441,71,3617,3617,0,0,3617,3574,3498,39,10,8,1,18,43,41,2,0,0,0,3617,61,3556,3617,1805,1812,3498,42,049,011300
42,011400,0000004816476,00004048,1626,1626,0,1626,1547,79,4048,4048,0,0,4048,4032,3994,21,1,9,0,7,16,16,0,0,0,0,4048,33,4015,4048,1876,2172,3994,42,049,011400
42,011503,0000005855515,00003851,1483,1483,0,1483,1432,51,3851,3851,0,0,3851,3834,3743,57,3,24,0,7,17,17,0,0,0,0,3851,12,3839,3851,1755,2096,3743,42,049,011503
42,011504,0000006764987,00004776,1810,1810,0,1810,1732,78,4776,4776,0,0,4776,4758,4672,52,4,27,0,3,18,18,0,0,0,0,4776,26,4750,4776,2451,2325,4672,42,049,011504
42,011505,0000021894950,00002778,1104,1104,0,1104,1040,64,2778,2778,0,0,2778,2759,2716,28,1,5,0,9,19,18,1,0,0,0,2778,16,2762,2778,1360,1418,2716,42,049,011505
42,011507,0000046641117,00002845,1021,1021,0,1021,976,45,2845,2845,0,0,2845,2832,2814,10,3,1,0,4,13,12,1,0,0,0,2845,20,2825,2845,1410,1435,2814,42,049,011507
42,011508,0000007542674,00000928,227,227,0,227,218,9,928,928,0,0,928,920,857,36,1,21,2,3,8,8,0,0,0,0,928,12,916,928,529,399,857,42,049,011508
42,011600,0000003389840,00004601,1795,1795,0,1795,1730,65,4601,4601,0,0,4601,4565,4493,37,4,4,0,27,36,35,1,0,0,0,4601,86,4515,4601,2235,2366,4493,42,049,011600
42,011701,0000037689775,00002962,1393,1393,0,1393,1237,156,2962,2962,0,0,2962,2953,2938,6,0,1,2,6,9,9,0,0,0,0,2962,21,2941,2962,1457,1505,2938,42,049,011701
42,011702,0000159626339,00006649,1997,1997,0,1997,1914,83,6649,6649,0,0,6649,6598,6465,77,5,34,1,16,51,44,5,0,2,0,6649,50,6599,6649,3414,3235,6465,42,049,011702
42,011801,0000113707887,00002655,987,987,0,987,919,68,2655,2655,0,0,2655,2645,2630,2,2,10,0,1,10,10,0,0,0,0,2655,7,2648,2655,1327,1328,2630,42,049,011801
42,011802,0000188744018,00003363,1305,1305,0,1305,1216,89,3363,3363,0,0,3363,3336,3311,2,5,16,0,2,27,27,0,0,0,0,3363,6,3357,3363,1684,1679,3311,42,049,011802
42,011900,0000015797075,00006834,2868,2868,0,2868,2660,208,6834,6834,0,0,6834,6768,6710,20,20,11,1,6,66,58,4,0,4,0,6834,62,6772,6834,3207,3627,6710,42,049,011900
42,012001,0000167763648,00002803,1039,1039,0,1039,985,54,2803,2803,0,0,2803,2798,2791,2,0,0,0,5,5,5,0,0,0,0,2803,9,2794,2803,1443,1360,2791,42,049,012001
42,012002,0000004851727,00003463,1422,1422,0,1422,1326,96,3463,3463,0,0,3463,3442,3391,5,11,26,1,8,21,18,3,0,0,0,3463,29,3434,3463,1630,1833,3391,42,049,012002
42,012100,0000222383831,00007419,2829,2829,0,2829,2636,193,7419,7419,0,0,7419,7359,7310,27,7,6,0,9,60,60,0,0,0,0,7419,35,7384,7419,3739,3680,7310,42,049,012100
42,012201,0000191613067,00006135,2289,2289,0,2289,2193,96,6135,6135,0,0,6135,6083,6041,16,6,11,0,9,52,46,4,2,0,0,6135,38,6097,6135,3132,3003,6041,42,049,012201
42,012202,0000005998886,00006950,2242,2242,0,2242,2087,155,6950,6950,0,0,6950,6884,6414,309,11,112,2,36,66,61,5,0,0,0,6950,69,6881,6950,3262,3688,6414,42,049,012202
42,260100,0000026159696,00006386,2985,2985,0,2985,2719,266,6386,6386,0,0,6386,6360,6243,86,11,13,0,7,26,26,0,0,0,0,6386,21,6365,6386,2961,3425,6243,42,051,260100
42,260200,0000055787847,00004550,2076,2076,0,2076,1968,108,4550,4550,0,0,4550,4528,4428,86,3,9,0,2,22,22,0,0,0,0,4550,9,4541,4550,2168,2382,4428,42,051,260200
42,260300,0000057491947,00004062,1681,1681,0,1681,1599,82,4062,4062,0,0,4062,4048,3993,50,2,2,1,0,14,14,0,0,0,0,4062,12,4050,4062,2038,2024,3993,42,051,260300
42,260401,0000029287808,00002681,1072,1072,0,1072,1032,40,2681,2681,0,0,2681,2679,2670,2,0,7,0,0,2,2,0,0,0,0,2681,1,2680,2681,1347,1334,2670,42,051,260401
42,260402,0000083088886,00005101,2134,2134,0,2134,1991,143,5101,5101,0,0,5101,5088,5062,2,7,6,3,8,13,13,0,0,0,0,5101,12,5089,5101,2597,2504,5062,42,051,260402
42,260500,0000252754262,00006827,3028,3028,0,3028,2544,484,6827,6827,0,0,6827,6783,6770,0,8,4,0,1,44,42,2,0,0,0,6827,34,6793,6827,3431,3396,6770,42,051,260500
42,260600,0000032625616,00004782,2050,2050,0,2050,1930,120,4782,4782,0,0,4782,4764,4712,46,1,2,0,3,18,18,0,0,0,0,4782,10,4772,4782,2339,2443,4712,42,051,260600
42,260700,0000002453881,00004376,2024,2024,0,2024,1823,201,4376,4376,0,0,4376,4337,4141,175,8,7,0,6,39,37,2,0,0,0,4376,18,4358,4376,2008,2368,4141,42,051,260700
42,260800,0000002785851,00004752,2401,2401,0,2401,2132,269,4752,4752,0,0,4752,4709,4488,184,4,23,0,10,43,38,5,0,0,0,4752,31,4721,4752,2234,2518,4488,42,051,260800
42,260900,0000051607403,00004705,1973,1973,0,1973,1853,120,4705,4705,0,0,4705,4687,4573,94,5,12,0,3,18,16,2,0,0,0,4705,12,4693,4705,2280,2425,4573,42,051,260900
42,261000,0000076730748,00002628,1072,1072,0,1072,1012,60,2628,2628,0,0,2628,2617,2582,23,4,1,0,7,11,10,1,0,0,0,2628,3,2625,2628,1299,1329,2582,42,051,261000
42,261100,0000053887726,00002810,1132,1132,0,1132,1087,45,2810,2810,0,0,2810,2796,2753,36,1,5,0,1,14,13,1,0,0,0,2810,13,2797,2810,1380,1430,2753,42,051,261100
42,261200,0000002596862,00002804,1550,1550,0,1550,1238,312,2804,2804,0,0,2804,2741,2410,320,3,2,0,6,63,63,0,0,0,0,2804,23,2781,2804,1273,1531,2410,42,051,261200
42,261300,0000080864682,00005452,2405,2405,0,2405,2222,183,5452,5452,0,0,5452,5393,5171,206,5,6,0,5,59,58,1,0,0,0,5452,20,5432,5452,2577,2875,5171,42,051,261300
42,261400,0000058524138,00006397,2943,2943,0,2943,2651,292,6397,6397,0,0,6397,6322,5771,515,7,7,3,19,75,72,3,0,0,0,6397,19,6378,6397,3027,3370,5771,42,051,261400
42,261500,0000055029487,00004644,1964,1964,0,1964,1810,154,4644,4644,0,0,4644,4604,4448,145,6,5,0,0,40,38,2,0,0,0,4644,16,4628,4644,2202,2442,4448,42,051,261500
42,261600,0000027502254,00003127,1358,1358,0,1358,1260,98,3127,3127,0,0,3127,3119,3098,8,5,8,0,0,8,6,1,0,1,0,3127,11,3116,3127,1527,1600,3098,42,051,261600
42,261700,0000008924697,00003317,1506,1506,0,1506,1359,147,3317,3317,0,0,3317,3287,3056,204,5,15,1,6,30,30,0,0,0,0,3317,14,3303,3317,1505,1812,3056,42,051,261700
42,261800,0000010095419,00004052,1893,1893,0,1893,1794,99,4052,4052,0,0,4052,4038,3901,120,3,6,1,7,14,14,0,0,0,0,4052,16,4036,4052,1885,2167,3901,42,051,261800
42,261900,0000001601774,00004057,2203,2203,0,2203,1828,375,4057,4057,0,0,4057,4017,3665,331,5,5,2,9,40,39,1,0,0,0,4057,29,4028,4057,1943,2114,3665,42,051,261900
42,262000,0000016620813,00005210,2063,2063,0,2063,1986,77,5210,5210,0,0,5210,5171,4992,88,3,83,1,4,39,33,6,0,0,0,5210,16,5194,5210,2363,2847,4992,42,051,262000
42,262100,0000002491673,00002830,1241,1241,0,1241,1167,74,2830,2830,0,0,2830,2802,2606,188,1,2,0,5,28,27,1,0,0,0,2830,15,2815,2830,1266,1564,2606,42,051,262100
42,262200,0000001873667,00003973,2067,2067,0,2067,1832,235,3973,3973,0,0,3973,3935,3732,153,0,42,1,7,38,38,0,0,0,0,3973,12,3961,3973,1815,2158,3732,42,051,262200
42,262300,0000001799730,00004392,2050,2050,0,2050,1763,287,4392,4392,0,0,4392,4290,3058,1202,7,3,1,19,102,88,13,0,1,0,4392,27,4365,4392,1994,2398,3058,42,051,262300
42,262400,0000024232100,00003297,1491,1491,0,1491,1410,81,3297,3297,0,0,3297,3272,3160,95,4,10,0,3,25,19,6,0,0,0,3297,6,3291,3297,1584,1713,3160,42,051,262400
42,262500,0000053702117,00003644,1477,1477,0,1477,1392,85,3644,3644,0,0,3644,3617,3564,36,4,11,0,2,27,27,0,0,0,0,3644,19,3625,3644,1783,1861,3564,42,051,262500
42,262600,0000098646092,00003454,1503,1503,0,1503,1367,136,3454,3454,0,0,3454,3438,3412,19,2,5,0,0,16,16,0,0,0,0,3454,12,3442,3454,1689,1765,3412,42,051,262600
42,262700,0000503793032,00007231,3543,3543,0,3543,2503,1040,7231,7231,0,0,7231,7209,7175,10,8,7,1,8,22,20,2,0,0,0,7231,28,7203,7231,3597,3634,7175,42,051,262700
42,262800,0000094136936,00007339,3018,3018,0,3018,2842,176,7339,7339,0,0,7339,7268,7132,124,8,2,0,2,71,70,1,0,0,0,7339,22,7317,7339,3552,3787,7132,42,051,262800
42,262900,0000086327501,00005595,2333,2333,0,2333,2148,185,5595,5595,0,0,5595,5562,5139,403,11,4,0,5,33,32,1,0,0,0,5595,25,5570,5595,2679,2916,5139,42,051,262900
42,263000,0000003935265,00003611,1701,1701,0,1701,1536,165,3611,3611,0,0,3611,3590,3368,202,8,1,0,11,21,21,0,0,0,0,3611,8,3603,3611,1639,1972,3368,42,051,263000
42,263100,0000144483194,00006296,2729,2729,0,2729,2466,263,6296,6296,0,0,6296,6248,6189,36,12,5,2,4,48,40,8,0,0,0,6296,42,6254,6296,3098,3198,6189,42,051,263100
42,263200,0000034979329,00002441,1047,1047,0,1047,980,67,2441,2441,0,0,2441,2429,2415,6,4,3,1,0,12,12,0,0,0,0,2441,8,2433,2441,1164,1277,2415,42,051,263200
42,263300,0000009626383,00001821,777,777,0,777,725,52,1821,1821,0,0,1821,1811,1780,28,3,0,0,0,10,10,0,0,0,0,1821,0,1821,1821,892,929,1780,42,051,263300
42,980100,0000535255243,00002027,3080,3080,0,3080,734,2346,2027,2027,0,0,2027,2015,1862,107,9,4,0,33,12,12,0,0,0,0,2027,49,1978,2027,1124,903,1862,42,053,980100
42,980200,0000573562111,00002919,5621,5621,0,5621,1266,4355,2919,2919,0,0,2919,2901,2883,3,11,3,0,1,18,18,0,0,0,0,2919,11,2908,2919,1480,1439,2883,42,053,980200
42,010100,0000292394385,00004091,1827,1827,0,1827,1487,340,4091,4091,0,0,4091,4085,4045,22,0,7,0,11,6,6,0,0,0,0,4091,17,4074,4091,2029,2062,4045,42,055,010100
42,010200,0000266985134,00004088,1578,1578,0,1578,1493,85,4088,4088,0,0,4088,4076,4023,30,3,6,1,13,12,12,0,0,0,0,4088,22,4066,4088,2096,1992,4023,42,055,010200
42,010300,0000100403075,00007488,2953,2953,0,2953,2832,121,7488,7488,0,0,7488,7424,7249,115,8,38,2,12,64,62,1,1,0,0,7488,46,7442,7488,3604,3884,7249,42,055,010300
42,010400,0000060443861,00006749,2940,2940,0,2940,2808,132,6749,6749,0,0,6749,6695,6491,101,5,56,7,35,54,51,3,0,0,0,6749,112,6637,6749,3253,3496,6491,42,055,010400
42,010500,0000086550872,00005535,2369,2369,0,2369,2214,155,5535,5535,0,0,5535,5500,5350,88,5,31,5,21,35,33,2,0,0,0,5535,49,5486,5535,2712,2823,5350,42,055,010500
42,010600,0000021088807,00006075,2294,2294,0,2294,2212,82,6075,6075,0,0,6075,5977,5705,172,17,54,1,28,98,96,1,1,0,0,6075,93,5982,6075,3037,3038,5705,42,055,010600
42,010700,0000115041806,00007025,2836,2836,0,2836,2732,104,7025,7025,0,0,7025,6968,6860,60,10,21,0,17,57,54,3,0,0,0,7025,71,6954,7025,3498,3527,6860,42,055,010700
42,010800,0000003828453,00003727,1894,1894,0,1894,1808,86,3727,3727,0,0,3727,3689,3475,105,5,53,0,51,38,37,1,0,0,0,3727,118,3609,3727,1647,2080,3475,42,055,010800
42,010900,0000005124474,00003963,1853,1853,0,1853,1726,127,3963,3963,0,0,3963,3903,3440,313,6,13,2,129,60,57,3,0,0,0,3963,228,3735,3963,1865,2098,3440,42,055,010900
42,011000,0000004426564,00003701,1773,1773,0,1773,1575,198,3701,3701,0,0,3701,3592,2620,627,15,40,5,285,109,102,5,2,0,0,3701,563,3138,3701,1741,1960,2620,42,055,011000
42,011100,0000002623144,00003727,1514,1514,0,1514,1438,76,3727,3727,0,0,3727,3674,3486,125,3,27,2,31,53,52,1,0,0,0,3727,79,3648,3727,1488,2239,3486,42,055,011100
42,011200,0000001781913,00002744,1271,1271,0,1271,1175,96,2744,2744,0,0,2744,2678,2418,180,4,22,0,54,66,62,4,0,0,0,2744,152,2592,2744,1293,1451,2418,42,055,011200
42,011300,0000092418647,00008949,3612,3612,0,3612,3476,136,8949,8949,0,0,8949,8857,8499,230,10,66,7,45,92,81,11,0,0,0,8949,127,8822,8949,4363,4586,8499,42,055,011300
42,011400,0000133918367,00005775,2292,2292,0,2292,2141,151,5775,5775,0,0,5775,5740,5657,38,15,16,0,14,35,32,3,0,0,0,5775,43,5732,5775,2920,2855,5657,42,055,011400
42,011500,0000147264442,00005791,2488,2488,0,2488,2308,180,5791,5791,0,0,5791,5760,5576,138,2,14,0,30,31,31,0,0,0,0,5791,77,5714,5791,2822,2969,5576,42,055,011500
42,011600,0000252885714,00005283,1997,1997,0,1997,1913,84,5283,5283,0,0,5283,5270,5239,13,6,3,0,9,13,13,0,0,0,0,5283,24,5259,5283,2763,2520,5239,42,055,011600
42,011700,0000090079434,00006474,2383,2383,0,2383,2305,78,6474,6474,0,0,6474,6428,6317,44,24,20,0,23,46,41,5,0,0,0,6474,50,6424,6474,3218,3256,6317,42,055,011700
42,011800,0000004065683,00003722,1748,1748,0,1748,1661,87,3722,3722,0,0,3722,3695,3600,50,7,23,2,13,27,26,1,0,0,0,3722,36,3686,3722,1799,1923,3600,42,055,011800
42,011900,0000091355143,00006030,2215,2215,0,2215,2167,48,6030,6030,0,0,6030,6009,5926,53,7,16,0,7,21,19,2,0,0,0,6030,48,5982,6030,3000,3030,5926,42,055,011900
42,012000,0000117144555,00007203,2493,2493,0,2493,2357,136,7203,7203,0,0,7203,7162,6929,143,9,39,1,41,41,31,7,3,0,0,7203,72,7131,7203,3589,3614,6929,42,055,012000
42,012100,0000036891505,00003044,1248,1248,0,1248,1182,66,3044,3044,0,0,3044,3028,2962,21,2,31,1,11,16,14,2,0,0,0,3044,22,3022,3044,1479,1565,2962,42,055,012100
42,012200,0000002431035,00003232,1581,1581,0,1581,1448,133,3232,3232,0,0,3232,3211,3122,60,2,10,1,16,21,21,0,0,0,0,3232,42,3190,3232,1530,1702,3122,42,055,012200
42,012300,0000002642589,00003766,1821,1821,0,1821,1666,155,3766,3766,0,0,3766,3716,3501,163,11,19,0,22,50,47,3,0,0,0,3766,57,3709,3766,1699,2067,3501,42,055,012300
42,012400,0000003620665,00002616,1231,1231,0,1231,1114,117,2616,2616,0,0,2616,2593,2530,29,1,19,0,14,23,19,1,0,3,0,2616,49,2567,2616,1274,1342,2530,42,055,012400
42,012501,0000047659282,00005021,2022,2022,0,2022,1947,75,5021,5021,0,0,5021,5003,4886,48,6,49,0,14,18,17,1,0,0,0,5021,32,4989,5021,2453,2568,4886,42,055,012501
42,012502,0000016182652,00003494,1570,1570,0,1570,1448,122,3494,3494,0,0,3494,3471,3373,48,9,24,3,14,23,23,0,0,0,0,3494,39,3455,3494,1743,1751,3373,42,055,012502
42,990100,0000195523372,00004543,2197,2197,0,2197,1875,322,4543,4543,0,0,4543,4495,4390,81,14,7,2,1,48,46,2,0,0,0,4543,27,4516,4543,2226,2317,4390,42,057,990100
42,990200,0000534602328,00005325,2582,2582,0,2582,2087,495,5325,5325,0,0,5325,5291,5268,7,10,4,0,2,34,34,0,0,0,0,5325,14,5311,5325,2656,2669,5268,42,057,990200
42,990300,0000403164063,00004393,2011,2011,0,2011,1698,313,4393,4393,0,0,4393,4372,4354,6,5,4,0,3,21,21,0,0,0,0,4393,11,4382,4393,2251,2142,4354,42,057,990300
42,970100,0000099497527,00007120,3148,3148,0,3148,2891,257,7120,7120,0,0,7120,7052,7017,18,15,1,0,1,68,57,9,2,0,0,7120,34,7086,7120,3430,3690,7017,42,059,970100
42,970200,0000058532720,00003308,1424,1424,0,1424,1334,90,3308,3308,0,0,3308,3293,3204,74,8,7,0,0,15,14,1,0,0,0,3308,14,3294,3308,1570,1738,3204,42,059,970200
42,970300,0000226432592,00004980,2017,2017,0,2017,1850,167,4980,4980,0,0,4980,4956,4909,29,9,3,5,1,24,24,0,0,0,0,4980,15,4965,4980,2505,2475,4909,42,059,970300
42,970400,0000562214601,00004877,2218,2218,0,2218,1837,381,4877,4877,0,0,4877,4836,4826,3,5,0,1,1,41,38,2,1,0,0,4877,12,4865,4877,2441,2436,4826,42,059,970400
42,970500,0000235054318,00008893,2814,2814,0,2814,2620,194,8893,8893,0,0,8893,8855,7417,1376,9,42,1,10,38,38,0,0,0,0,8893,213,8680,8893,5312,3581,7417,42,059,970500
42,970600,0000002150716,00004184,1811,1811,0,1811,1619,192,4184,4184,0,0,4184,4161,4056,68,4,24,2,7,23,23,0,0,0,0,4184,27,4157,4184,2066,2118,4056,42,059,970600
42,970700,0000180577940,00002943,1307,1307,0,1307,1148,159,2943,2943,0,0,2943,2929,2914,6,8,1,0,0,14,13,1,0,0,0,2943,17,2926,2943,1453,1490,2914,42,059,970700
42,970800,0000127011616,00004367,1939,1939,0,1939,1761,178,4367,4367,0,0,4367,4346,4322,11,3,9,0,1,21,20,1,0,0,0,4367,25,4342,4367,2174,2193,4322,42,059,970800
42,950100,0000307741928,00001856,1161,1161,0,1161,723,438,1856,1856,0,0,1856,1846,1837,4,0,1,0,4,10,10,0,0,0,0,1856,3,1853,1856,939,917,1837,42,061,950100
42,950200,0000291455660,00003380,1537,1537,0,1537,1299,238,3380,3380,0,0,3380,3377,3351,3,2,3,0,18,3,3,0,0,0,0,3380,21,3359,3380,1691,1689,3351,42,061,950200
42,950300,0000166311030,00007942,2175,2175,0,2175,1968,207,7942,7942,0,0,7942,7843,5799,1880,10,19,4,131,99,98,1,0,0,0,7942,321,7621,7942,5463,2479,5799,42,061,950300
42,950400,0000008931070,00006918,2817,2817,0,2817,2626,191,6918,6918,0,0,6918,6841,6669,97,12,42,0,21,77,77,0,0,0,0,6918,46,6872,6918,3167,3751,6669,42,061,950400
42,950500,0000195003596,00003487,1652,1652,0,1652,1363,289,3487,3487,0,0,3487,3470,3435,18,2,14,0,1,17,16,1,0,0,0,3487,10,3477,3487,1727,1760,3435,42,061,950500
42,950600,0000215734888,00003889,2155,2155,0,2155,1538,617,3889,3889,0,0,3889,3872,3845,10,4,4,0,9,17,17,0,0,0,0,3889,11,3878,3889,1939,1950,3845,42,061,950600
42,950800,0000304103089,00003696,2102,2102,0,2102,1401,701,3696,3696,0,0,3696,3674,3648,18,3,0,0,5,22,20,2,0,0,0,3696,27,3669,3696,1858,1838,3648,42,061,950800
42,950900,0000002919168,00002504,1288,1288,0,1288,1166,122,2504,2504,0,0,2504,2451,2166,276,1,0,0,8,53,50,3,0,0,0,2504,30,2474,2504,1124,1380,2166,42,061,950900
42,951000,0000151198344,00002666,1336,1336,0,1336,1049,287,2666,2666,0,0,2666,2654,2625,16,5,7,0,1,12,12,0,0,0,0,2666,19,2647,2666,1318,1348,2625,42,061,951000
42,951100,0000205436870,00002025,993,993,0,993,754,239,2025,2025,0,0,2025,2016,2007,6,2,0,0,1,9,9,0,0,0,0,2025,9,2016,2025,1031,994,2007,42,061,951100
42,951200,0000282072275,00004791,2552,2552,0,2552,1897,655,4791,4791,0,0,4791,4769,4751,10,2,2,0,4,22,22,0,0,0,0,4791,16,4775,4791,2346,2445,4751,42,061,951200
42,951300,0000132883402,00002432,1290,1290,0,1290,975,315,2432,2432,0,0,2432,2424,2411,4,5,2,0,2,8,8,0,0,0,0,2432,11,2421,2432,1239,1193,2411,42,061,951300
42,960100,0000228511296,00004356,1793,1793,0,1793,1533,260,4356,4356,0,0,4356,4332,4319,4,1,4,0,4,24,23,1,0,0,0,4356,11,4345,4356,2202,2154,4319,42,063,960100
42,960200,0000234981009,00005018,1871,1871,0,1871,1637,234,5018,5018,0,0,5018,5009,4976,8,4,13,4,4,9,9,0,0,0,0,5018,0,5018,5018,2508,2510,4976,42,063,960200
42,960300,0000145520360,00002845,1205,1205,0,1205,1029,176,2845,2845,0,0,2845,2831,2822,5,3,1,0,0,14,14,0,0,0,0,2845,10,2835,2845,1398,1447,2822,42,063,960300
42,960400,0000136656451,00003995,1577,1577,0,1577,1431,146,3995,3995,0,0,3995,3960,3949,7,0,0,0,4,35,34,1,0,0,0,3995,21,3974,3995,1989,2006,3949,42,063,960400
42,960500,0000122872870,00003793,1539,1539,0,1539,1428,111,3793,3793,0,0,3793,3777,3753,13,3,6,0,2,16,15,1,0,0,0,3793,12,3781,3793,1908,1885,3753,42,063,960500
42,960600,0000197577470,00005345,2154,2154,0,2154,2022,132,5345,5345,0,0,5345,5315,5275,20,1,10,0,9,30,29,1,0,0,0,5345,23,5322,5345,2666,2679,5275,42,063,960600
42,960700,0000022342893,00006200,2961,2961,0,2961,2754,207,6200,6200,0,0,6200,6128,5713,172,9,215,0,19,72,71,1,0,0,0,6200,59,6141,6200,2859,3341,5713,42,063,960700
42,960800,0000044824894,00003910,1628,1628,0,1628,1534,94,3910,3910,0,0,3910,3893,3796,37,4,52,0,4,17,16,1,0,0,0,3910,22,3888,3910,1846,2064,3796,42,063,960800
42,960900,0000043098427,00003924,1964,1964,0,1964,1737,227,3924,3924,0,0,3924,3895,3707,139,3,34,0,12,29,28,1,0,0,0,3924,16,3908,3924,1880,2044,3707,42,063,960900
42,961000,0000001298875,00002355,1057,1057,0,1057,988,69,2355,2355,0,0,2355,2339,2270,44,4,16,1,4,16,16,0,0,0,0,2355,19,2336,2355,1210,1145,2270,42,063,961000
42,961101,0000001465119,00004893,2209,2209,0,2209,2081,128,4893,4893,0,0,4893,4852,4575,161,1,101,1,13,41,36,5,0,0,0,4893,46,4847,4893,2145,2748,4575,42,063,961101
42,961102,0000000505960,00005078,598,598,0,598,580,18,5078,5078,0,0,5078,5028,4350,522,3,115,1,37,50,49,1,0,0,0,5078,83,4995,5078,2191,2887,4350,42,063,961102
42,961200,0000001300874,00002569,1232,1232,0,1232,1155,77,2569,2569,0,0,2569,2543,2435,46,2,49,0,11,26,25,1,0,0,0,2569,30,2539,2569,1246,1323,2435,42,063,961200
42,961300,0000127952342,00004389,1833,1833,0,1833,1677,156,4389,4389,0,0,4389,4376,4351,14,5,5,0,1,13,13,0,0,0,0,4389,6,4383,4389,2140,2249,4351,42,063,961300
42,961400,0000159327845,00003415,1411,1411,0,1411,1284,127,3415,3415,0,0,3415,3399,3390,3,6,0,0,0,16,16,0,0,0,0,3415,9,3406,3415,1715,1700,3390,42,063,961400
42,961500,0000189365856,00004256,1768,1768,0,1768,1598,170,4256,4256,0,0,4256,4245,4231,4,2,6,0,2,11,11,0,0,0,0,4256,16,4240,4256,2176,2080,4231,42,063,961500
42,961600,0000104576930,00004876,2132,2132,0,2132,2024,108,4876,4876,0,0,4876,4865,4825,25,5,6,0,4,11,11,0,0,0,0,4876,22,4854,4876,2417,2459,4825,42,063,961600
42,961700,0000001448000,00001844,869,869,0,869,805,64,1844,1844,0,0,1844,1838,1833,4,0,1,0,0,6,6,0,0,0,0,1844,6,1838,1844,858,986,1833,42,063,961700
42,961800,0000090223560,00001744,805,805,0,805,741,64,1744,1744,0,0,1744,1736,1724,8,3,1,0,0,8,8,0,0,0,0,1744,0,1744,1744,845,899,1724,42,063,961800
42,961900,0000159184690,00004709,2008,2008,0,2008,1879,129,4709,4709,0,0,4709,4687,4672,3,2,6,0,4,22,21,1,0,0,0,4709,18,4691,4709,2326,2383,4672,42,063,961900
42,962000,0000061428107,00003746,1632,1632,0,1632,1495,137,3746,3746,0,0,3746,3732,3665,59,3,1,0,4,14,14,0,0,0,0,3746,17,3729,3746,1834,1912,3665,42,063,962000
42,962100,0000003605242,00003607,1830,1830,0,1830,1631,199,3607,3607,0,0,3607,3586,3451,108,4,21,0,2,21,19,2,0,0,0,3607,2,3605,3607,1697,1910,3451,42,063,962100
42,962200,0000069734039,00002738,1174,1174,0,1174,1080,94,2738,2738,0,0,2738,2723,2714,1,3,2,1,2,15,15,0,0,0,0,2738,9,2729,2738,1366,1372,2714,42,063,962200
42,950100,0000003006792,00002182,994,994,0,994,911,83,2182,2182,0,0,2182,2180,2175,0,1,4,0,0,2,2,0,0,0,0,2182,2,2180,2182,1037,1145,2175,42,065,950100
42,950200,0000299358068,00003158,2537,2537,0,2537,1249,1288,3158,3158,0,0,3158,3137,3119,6,6,4,0,2,21,21,0,0,0,0,3158,19,3139,3158,1605,1553,3119,42,065,950200
42,950300,0000378968473,00005493,2869,2869,0,2869,2157,712,5493,5493,0,0,5493,5465,5437,6,13,8,1,0,28,27,0,1,0,0,5493,19,5474,5493,2783,2710,5437,42,065,950300
42,950400,0000004342029,00002059,1003,1003,0,1003,944,59,2059,2059,0,0,2059,2048,2005,10,3,26,0,4,11,11,0,0,0,0,2059,13,2046,2059,954,1105,2005,42,065,950400
42,950500,0000004004534,00002171,973,973,0,973,905,68,2171,2171,0,0,2171,2161,2155,1,1,4,0,0,10,10,0,0,0,0,2171,7,2164,2171,975,1196,2155,42,065,950500
42,950600,0000295037410,00005826,2522,2522,0,2522,2179,343,5826,5826,0,0,5826,5791,5765,5,3,10,0,8,35,35,0,0,0,0,5826,9,5817,5826,2910,2916,5765,42,065,950600
42,950700,0000003744996,00002710,1233,1233,0,1233,1117,116,2710,2710,0,0,2710,2696,2679,4,10,3,0,0,14,11,3,0,0,0,2710,15,2695,2710,1301,1409,2679,42,065,950700
42,950800,0000121879027,00003837,1718,1718,0,1718,1544,174,3837,3837,0,0,3837,3833,3816,5,6,5,0,1,4,4,0,0,0,0,3837,18,3819,3837,1914,1923,3816,42,065,950800
42,950900,0000307157183,00004244,1883,1883,0,1883,1640,243,4244,4244,0,0,4244,4229,4199,4,11,8,0,7,15,11,4,0,0,0,4244,15,4229,4244,2188,2056,4199,42,065,950900
42,951000,0000182634676,00004152,1700,1700,0,1700,1483,217,4152,4152,0,0,4152,4133,4109,3,9,1,4,7,19,19,0,0,0,0,4152,14,4138,4152,2089,2063,4109,42,065,951000
42,951100,0000088705933,00003829,1630,1630,0,1630,1498,132,3829,3829,0,0,3829,3815,3803,1,2,7,0,2,14,14,0,0,0,0,3829,10,3819,3829,1905,1924,3803,42,065,951100
42,951200,0000004067636,00003365,1611,1611,0,1611,1469,142,3365,3365,0,0,3365,3335,3304,11,6,14,0,0,30,30,0,0,0,0,3365,32,3333,3365,1516,1849,3304,42,065,951200
42,951300,0000004777836,00002906,1431,1431,0,1431,1279,152,2906,2906,0,0,2906,2902,2891,3,4,3,0,1,4,4,0,0,0,0,2906,15,2891,2906,1288,1618,2891,42,065,951300
42,970100,0000186451448,00006657,2865,2865,0,2865,2562,303,6657,6657,0,0,6657,6639,6536,19,4,22,37,21,18,17,0,0,1,0,6657,112,6545,6657,3248,3409,6536,42,067,970100
42,970200,0000531125252,00007540,3724,3724,0,3724,2889,835,7540,7540,0,0,7540,7477,7303,39,22,25,2,86,63,58,4,1,0,0,7540,225,7315,7540,3791,3749,7303,42,067,970200
42,970300,0000152147138,00004773,2010,2010,0,2010,1824,186,4773,4773,0,0,4773,4762,4731,13,4,8,0,6,11,11,0,0,0,0,4773,20,4753,4773,2369,2404,4731,42,067,970300
42,970400,0000144496918,00003851,1432,1432,0,1432,1309,123,3851,3851,0,0,3851,3826,3806,14,2,2,0,2,25,22,2,1,0,0,3851,12,3839,3851,1945,1906,3806,42,067,970400
42,100200,0000000932713,00002597,1536,1536,0,1536,1231,305,2597,2597,0,0,2597,2535,2017,324,3,149,4,38,62,57,3,2,0,0,2597,137,2460,2597,1320,1277,2017,42,069,100200
42,100300,0000000712280,00003962,1052,1052,0,1052,849,203,3962,3962,0,0,3962,3917,3594,146,3,106,0,68,45,43,2,0,0,0,3962,145,3817,3962,1663,2299,3594,42,069,100300
42,100400,0000000484491,00002194,1040,1040,0,1040,883,157,2194,2194,0,0,2194,2153,1865,154,5,43,0,86,41,40,0,1,0,0,2194,119,2075,2194,1051,1143,1865,42,069,100400
42,100500,0000001374556,00002111,991,991,0,991,920,71,2111,2111,0,0,2111,2096,2037,28,0,23,0,8,15,15,0,0,0,0,2111,34,2077,2111,976,1135,2037,42,069,100500
42,100600,0000001613542,00004154,1974,1974,0,1974,1641,333,4154,4154,0,0,4154,4076,3591,317,10,85,0,73,78,66,12,0,0,0,4154,178,3976,4154,1993,2161,3591,42,069,100600
42,100800,0000000681543,00003036,1217,1217,0,1217,1063,154,3036,3036,0,0,3036,2993,2730,215,6,18,0,24,43,40,2,1,0,0,3036,80,2956,3036,1622,1414,2730,42,069,100800
42,100900,0000001228507,00001637,819,819,0,819,726,93,1637,1637,0,0,1637,1614,1537,36,4,15,2,20,23,21,2,0,0,0,1637,33,1604,1637,802,835,1537,42,069,100900
42,101000,0000002461902,00003856,1468,1468,0,1468,1352,116,3856,3856,0,0,3856,3836,3776,21,5,26,0,8,20,19,1,0,0,0,3856,20,3836,3856,1474,2382,3776,42,069,101000
42,101100,0000001017566,00002884,1328,1328,0,1328,1181,147,2884,2884,0,0,2884,2858,2794,42,1,14,0,7,26,26,0,0,0,0,2884,27,2857,2884,1396,1488,2794,42,069,101100
42,101200,0000006321336,00002858,1343,1343,0,1343,1215,128,2858,2858,0,0,2858,2835,2709,54,2,48,0,22,23,23,0,0,0,0,2858,59,2799,2858,1333,1525,2709,42,069,101200
42,101300,0000001108508,00002881,1382,1382,0,1382,1221,161,2881,2881,0,0,2881,2854,2792,26,2,6,0,28,27,25,2,0,0,0,2881,58,2823,2881,1385,1496,2792,42,069,101300
42,101400,0000001774546,00002866,1289,1289,0,1289,1120,169,2866,2866,0,0,2866,2782,2453,173,15,22,0,119,84,80,4,0,0,0,2866,289,2577,2866,1295,1571,2453,42,069,101400
42,101600,0000000572929,00002681,1280,1280,0,1280,1149,131,2681,2681,0,0,2681,2652,2616,11,1,1,0,23,29,25,4,0,0,0,2681,36,2645,2681,1286,1395,2616,42,069,101600
42,101700,0000001425036,00003253,1488,1488,0,1488,1373,115,3253,3253,0,0,3253,3248,3219,9,0,3,3,14,5,4,1,0,0,0,3253,35,3218,3253,1504,1749,3219,42,069,101700
42,101800,0000010043796,00003722,1698,1698,0,1698,1610,88,3722,3722,0,0,3722,3700,3639,17,1,40,0,3,22,21,1,0,0,0,3722,13,3709,3722,1738,1984,3639,42,069,101800
42,101900,0000001291861,00001606,697,697,0,697,652,45,1606,1606,0,0,1606,1604,1567,13,0,18,0,6,2,2,0,0,0,0,1606,8,1598,1606,744,862,1567,42,069,101900
42,102000,0000000446291,00002253,1094,1094,0,1094,971,123,2253,2253,0,0,2253,2242,2202,22,0,3,0,15,11,9,2,0,0,0,2253,34,2219,2253,1059,1194,2202,42,069,102000
42,102100,0000000651366,00002463,1259,1259,0,1259,1097,162,2463,2463,0,0,2463,2444,2402,12,6,14,0,10,19,14,5,0,0,0,2463,23,2440,2463,1118,1345,2402,42,069,102100
42,102200,0000000748846,00002490,1164,1164,0,1164,1067,97,2490,2490,0,0,2490,2472,2433,29,3,5,0,2,18,18,0,0,0,0,2490,29,2461,2490,1179,1311,2433,42,069,102200
42,102300,0000001859523,00003862,1908,1908,0,1908,1684,224,3862,3862,0,0,3862,3842,3698,62,0,38,0,44,20,20,0,0,0,0,3862,76,3786,3862,1803,2059,3698,42,069,102300
42,102500,0000001548489,00003184,1685,1685,0,1685,1423,262,3184,3184,0,0,3184,3128,2893,134,1,41,1,58,56,52,4,0,0,0,3184,101,3083,3184,1520,1664,2893,42,069,102500
42,102600,0000000535703,00002352,1294,1294,0,1294,1120,174,2352,2352,0,0,2352,2334,2197,80,5,8,0,44,18,18,0,0,0,0,2352,129,2223,2352,1084,1268,2197,42,069,102600
42,102700,0000001455387,00002904,1333,1333,0,1333,1247,86,2904,2904,0,0,2904,2888,2832,16,1,22,2,15,16,16,0,0,0,0,2904,40,2864,2904,1378,1526,2832,42,069,102700
42,102800,0000019045570,00003048,1475,1475,0,1475,1360,115,3048,3048,0,0,3048,3042,2959,34,0,37,0,12,6,6,0,0,0,0,3048,20,3028,3048,1418,1630,2959,42,069,102800
42,102900,0000002831798,00003759,1809,1809,0,1809,1571,238,3759,3759,0,0,3759,3677,3237,293,9,12,3,123,82,74,7,0,0,1,3759,220,3539,3759,1639,2120,3237,42,069,102900
42,103000,0000001413786,00002157,1010,1010,0,1010,925,85,2157,2157,0,0,2157,2135,2070,32,1,17,0,15,22,19,3,0,0,0,2157,48,2109,2157,967,1190,2070,42,069,103000
42,103100,0000001752669,00001645,703,703,0,703,652,51,1645,1645,0,0,1645,1640,1621,4,1,9,0,5,5,5,0,0,0,0,1645,8,1637,1645,796,849,1621,42,069,103100
42,110100,0000042958541,00003069,1346,1346,0,1346,1237,109,3069,3069,0,0,3069,3056,3024,8,1,12,0,11,13,13,0,0,0,0,3069,20,3049,3069,1444,1625,3024,42,069,110100
42,110201,0000117510747,00003871,2018,2018,0,2018,1489,529,3871,3871,0,0,3871,3854,3825,14,4,8,0,3,17,16,1,0,0,0,3871,16,3855,3871,1903,1968,3825,42,069,110201
42,110202,0000070792568,00004931,2123,2123,0,2123,1841,282,4931,4931,0,0,4931,4909,4850,32,0,18,0,9,22,19,3,0,0,0,4931,35,4896,4931,2496,2435,4850,42,069,110202
42,110300,0000065152176,00004202,1683,1683,0,1683,1591,92,4202,4202,0,0,4202,4173,4104,9,4,51,0,5,29,28,1,0,0,0,4202,37,4165,4202,2071,2131,4104,42,069,110300
42,110401,0000012203152,00006316,2352,2352,0,2352,2281,71,6316,6316,0,0,6316,6272,6082,32,1,148,0,9,44,43,0,1,0,0,6316,58,6258,6316,3072,3244,6082,42,069,110401
42,110402,0000014833417,00002568,1032,1032,0,1032,1000,32,2568,2568,0,0,2568,2557,2468,14,0,75,0,0,11,11,0,0,0,0,2568,22,2546,2568,1250,1318,2468,42,069,110402
42,110403,0000009403006,00002908,897,897,0,897,847,50,2908,2908,0,0,2908,2901,2836,17,2,42,1,3,7,7,0,0,0,0,2908,23,2885,2908,1350,1558,2836,42,069,110403
42,110500,0000004321593,00005218,2308,2308,0,2308,2223,85,5218,5218,0,0,5218,5198,5099,21,5,60,1,12,20,20,0,0,0,0,5218,50,5168,5218,2463,2755,5099,42,069,110500
42,110600,0000041810117,00002764,1228,1228,0,1228,1155,73,2764,2764,0,0,2764,2761,2753,1,2,3,0,2,3,3,0,0,0,0,2764,14,2750,2764,1334,1430,2753,42,069,110600
42,110700,0000003828811,00002554,1179,1179,0,1179,1093,86,2554,2554,0,0,2554,2542,2527,7,3,2,0,3,12,12,0,0,0,0,2554,16,2538,2554,1106,1448,2527,42,069,110700
42,110800,0000001738480,00003936,1899,1899,0,1899,1650,249,3936,3936,0,0,3936,3910,3858,16,12,11,0,13,26,21,5,0,0,0,3936,75,3861,3936,1809,2127,3858,42,069,110800
42,110900,0000002819815,00003314,1449,1449,0,1449,1341,108,3314,3314,0,0,3314,3301,3277,0,5,10,0,9,13,13,0,0,0,0,3314,31,3283,3314,1533,1781,3277,42,069,110900
42,111000,0000002020714,00002287,1012,1012,0,1012,942,70,2287,2287,0,0,2287,2284,2252,17,5,9,0,1,3,3,0,0,0,0,2287,8,2279,2287,1103,1184,2252,42,069,111000
42,111100,0000043557103,00006220,2594,2594,0,2594,2470,124,6220,6220,0,0,6220,6177,6136,17,10,13,0,1,43,43,0,0,0,0,6220,25,6195,6220,2984,3236,6136,42,069,111100
42,111200,0000010009506,00007027,3010,3010,0,3010,2843,167,7027,7027,0,0,7027,6988,6909,20,3,32,0,24,39,36,3,0,0,0,7027,54,6973,7027,3154,3873,6909,42,069,111200
42,111300,0000017335156,00004718,2073,2073,0,2073,1976,97,4718,4718,0,0,4718,4690,4657,13,0,13,1,6,28,27,1,0,0,0,4718,13,4705,4718,2193,2525,4657,42,069,111300
42,111400,0000013933630,00004978,2381,2381,0,2381,2197,184,4978,4978,0,0,4978,4953,4903,23,1,20,2,4,25,25,0,0,0,0,4978,27,4951,4978,2328,2650,4903,42,069,111400
42,111500,0000002911637,00003590,1625,1625,0,1625,1516,109,3590,3590,0,0,3590,3583,3563,3,2,14,0,1,7,7,0,0,0,0,3590,16,3574,3590,1719,1871,3563,42,069,111500
42,111600,0000009286927,00002615,1288,1288,0,1288,1176,112,2615,2615,0,0,2615,2597,2569,12,2,2,0,12,18,18,0,0,0,0,2615,36,2579,2615,1192,1423,2569,42,069,111600
42,111700,0000013042449,00004010,1813,1813,0,1813,1709,104,4010,4010,0,0,4010,3994,3969,19,0,5,0,1,16,16,0,0,0,0,4010,30,3980,4010,1914,2096,3969,42,069,111700
42,111800,0000154715062,00007950,3173,3173,0,3173,2891,282,7950,7950,0,0,7950,7912,7853,23,3,27,0,6,38,33,5,0,0,0,7950,32,7918,7950,3907,4043,7853,42,069,111800
42,112000,0000006111897,00004056,1788,1788,0,1788,1701,87,4056,4056,0,0,4056,4036,3997,21,1,10,2,5,20,20,0,0,0,0,4056,37,4019,4056,1857,2199,3997,42,069,112000
42,112100,0000014157063,00004327,2111,2111,0,2111,1968,143,4327,4327,0,0,4327,4306,4245,18,2,32,0,9,21,20,1,0,0,0,4327,30,4297,4327,2058,2269,4245,42,069,112100
42,112200,0000000880892,00002760,1218,1218,0,1218,1155,63,2760,2760,0,0,2760,2757,2737,8,3,5,0,4,3,3,0,0,0,0,2760,28,2732,2760,1309,1451,2737,42,069,112200
42,112300,0000001489069,00002875,1411,1411,0,1411,1317,94,2875,2875,0,0,2875,2868,2822,22,2,15,0,7,7,7,0,0,0,0,2875,28,2847,2875,1345,1530,2822,42,069,112300
42,112400,0000103719782,00004128,1540,1540,0,1540,1461,79,4128,4128,0,0,4128,4125,4089,9,8,12,0,7,3,3,0,0,0,0,4128,16,4112,4128,2114,2014,4089,42,069,112400
42,112500,0000013524455,00006475,2872,2872,0,2872,2678,194,6475,6475,0,0,6475,6460,6367,22,5,40,0,26,15,14,1,0,0,0,6475,41,6434,6475,3007,3468,6367,42,069,112500
42,112600,0000005811943,00005810,2630,2630,0,2630,2477,153,5810,5810,0,0,5810,5796,5759,12,3,17,0,5,14,13,1,0,0,0,5810,20,5790,5810,2688,3122,5759,42,069,112600
42,112700,0000003135034,00002988,1351,1351,0,1351,1269,82,2988,2988,0,0,2988,2977,2952,2,0,17,0,6,11,11,0,0,0,0,2988,10,2978,2988,1375,1613,2952,42,069,112700
42,112800,0000016723975,00005575,2206,2206,0,2206,2080,126,5575,5575,0,0,5575,5559,5502,16,0,27,0,14,16,15,1,0,0,0,5575,30,5545,5575,2638,2937,5502,42,069,112800
42,112900,0000302774939,00008840,4416,4416,0,4416,3341,1075,8840,8840,0,0,8840,8789,8696,41,11,29,0,12,51,47,4,0,0,0,8840,81,8759,8840,4355,4485,8696,42,069,112900
42,000100,0000000553022,00002566,1431,1431,0,1431,1268,163,2566,2566,0,0,2566,2481,1416,386,38,30,5,606,85,79,6,0,0,0,2566,1022,1544,2566,1295,1271,1416,42,071,000100
42,000200,0000001183161,00002671,1131,1131,0,1131,1048,83,2671,2671,0,0,2671,2605,1706,314,2,255,0,328,66,57,7,0,2,0,2671,651,2020,2671,1305,1366,1706,42,071,000200
42,000300,0000000838325,00004686,1989,1989,0,1989,1855,134,4686,4686,0,0,4686,4508,3273,513,9,158,2,553,178,159,15,3,1,0,4686,1020,3666,4686,2272,2414,3273,42,071,000300
42,000400,0000000712402,00004062,2134,2134,0,2134,1927,207,4062,4062,0,0,4062,3940,2862,442,26,78,3,529,122,118,3,1,0,0,4062,1027,3035,4062,1832,2230,2862,42,071,000400
42,000500,0000000872040,00004731,1637,1637,0,1637,1501,136,4731,4731,0,0,4731,4604,3970,277,10,188,4,155,127,121,6,0,0,0,4731,359,4372,4731,2248,2483,3970,42,071,000500
42,000600,0000000506439,00003176,1694,1694,0,1694,1493,201,3176,3176,0,0,3176,3072,2509,247,4,40,3,269,104,100,4,0,0,0,3176,580,2596,3176,1533,1643,2509,42,071,000600
42,000700,0000000412080,00003714,1272,1272,0,1272,1135,137,3714,3714,0,0,3714,3539,2141,722,9,148,3,516,175,168,7,0,0,0,3714,965,2749,3714,2146,1568,2141,42,071,000700
42,000800,0000000978155,00004444,1292,1292,0,1292,1200,92,4444,4444,0,0,4444,4238,1472,1050,24,97,1,1594,206,192,9,5,0,0,4444,2406,2038,4444,2115,2329,1472,42,071,000800
42,000900,0000000374594,00003555,1452,1452,0,1452,1280,172,3555,3555,0,0,3555,3379,1299,850,26,60,9,1135,176,161,12,2,1,0,3555,1953,1602,3555,1708,1847,1299,42,071,000900
42,001000,0000000404886,00003435,1367,1367,0,1367,1196,171,3435,3435,0,0,3435,3219,1974,516,13,46,0,670,216,210,5,1,0,0,3435,1133,2302,3435,1693,1742,1974,42,071,001000
42,001100,0000000407730,00003106,1356,1356,0,1356,1255,101,3106,3106,0,0,3106,2995,2509,254,18,55,3,156,111,105,6,0,0,0,3106,459,2647,3106,1466,1640,2509,42,071,001100
42,001200,0000001353418,00004293,1972,1972,0,1972,1889,83,4293,4293,0,0,4293,4183,3399,369,7,135,2,271,110,104,6,0,0,0,4293,605,3688,4293,2004,2289,3399,42,071,001200
42,001400,0000001045587,00004922,1809,1809,0,1809,1559,250,4922,4922,0,0,4922,4642,2492,845,36,37,3,1229,280,271,9,0,0,0,4922,2190,2732,4922,2516,2406,2492,42,071,001400
42,001500,0000000843795,00001351,440,440,0,440,383,57,1351,1351,0,0,1351,1276,329,309,13,2,4,619,75,73,1,1,0,0,1351,875,476,1351,630,721,329,42,071,001500
42,001600,0000000301829,00002830,881,881,0,881,797,84,2830,2830,0,0,2830,2688,829,706,8,25,4,1116,142,140,2,0,0,0,2830,1903,927,2830,1386,1444,829,42,071,001600
42,010101,0000071442242,00006967,2383,2383,0,2383,2298,85,6967,6967,0,0,6967,6933,6849,22,6,27,0,29,34,32,2,0,0,0,6967,75,6892,6967,3455,3512,6849,42,071,010101
42,010102,0000003383214,00003332,1298,1298,0,1298,1266,32,3332,3332,0,0,3332,3308,3225,27,0,33,1,22,24,23,1,0,0,0,3332,76,3256,3332,1625,1707,3225,42,071,010102
42,010201,0000068733411,00004683,1609,1609,0,1609,1573,36,4683,4683,0,0,4683,4666,4625,14,1,12,0,14,17,15,2,0,0,0,4683,48,4635,4683,2408,2275,4625,42,071,010201
42,010202,0000034386464,00004323,1526,1526,0,1526,1489,37,4323,4323,0,0,4323,4282,4219,9,2,40,2,10,41,40,1,0,0,0,4323,29,4294,4323,2180,2143,4219,42,071,010202
42,010300,0000076731804,00007312,2671,2671,0,2671,2606,65,7312,7312,0,0,7312,7278,7132,61,11,53,4,17,34,32,2,0,0,0,7312,63,7249,7312,3607,3705,7132,42,071,010300
42,010400,0000003626492,00004784,2075,2075,0,2075,1989,86,4784,4784,0,0,4784,4723,4611,30,4,48,1,29,61,60,1,0,0,0,4784,81,4703,4784,2319,2465,4611,42,071,010400
42,010501,0000060323323,00004268,1515,1515,0,1515,1480,35,4268,4268,0,0,4268,4240,4192,11,4,10,0,23,28,27,1,0,0,0,4268,26,4242,4268,2166,2102,4192,42,071,010501
42,010502,0000062793090,00004310,1670,1670,0,1670,1595,75,4310,4310,0,0,4310,4287,4190,14,3,59,0,21,23,23,0,0,0,0,4310,43,4267,4310,2186,2124,4190,42,071,010502
42,010600,0000072310196,00007923,2939,2939,0,2939,2889,50,7923,7923,0,0,7923,7873,7696,20,11,85,4,57,50,46,4,0,0,0,7923,110,7813,7923,3959,3964,7696,42,071,010600
42,010701,0000003194691,00005754,2435,2435,0,2435,2342,93,5754,5754,0,0,5754,5698,5531,51,13,88,4,11,56,55,1,0,0,0,5754,76,5678,5754,2782,2972,5531,42,071,010701
42,010702,0000003647815,00006154,2056,2056,0,2056,1936,120,6154,6154,0,0,6154,6106,5940,56,8,58,1,43,48,45,3,0,0,0,6154,96,6058,6154,2588,3566,5940,42,071,010702
42,010801,0000040314383,00006539,2560,2560,0,2560,2474,86,6539,6539,0,0,6539,6498,6424,18,6,30,3,17,41,39,2,0,0,0,6539,46,6493,6539,3207,3332,6424,42,071,010801
42,010802,0000038441756,00003067,1130,1130,0,1130,1103,27,3067,3067,0,0,3067,3055,3035,1,4,5,1,9,12,12,0,0,0,0,3067,26,3041,3067,1565,1502,3035,42,071,010802
42,010900,0000006073780,00006765,2957,2957,0,2957,2839,118,6765,6765,0,0,6765,6694,6475,100,8,34,0,77,71,68,3,0,0,0,6765,209,6556,6765,3289,3476,6475,42,071,010900
42,011000,0000001941567,00002689,1168,1168,0,1168,1092,76,2689,2689,0,0,2689,2667,2577,67,4,4,1,14,22,22,0,0,0,0,2689,51,2638,2689,1344,1345,2577,42,071,011000
42,011100,0000056504273,00005405,2010,2010,0,2010,1941,69,5405,5405,0,0,5405,5365,5253,41,3,31,2,35,40,38,2,0,0,0,5405,96,5309,5405,2712,2693,5253,42,071,011100
42,011200,0000001068759,00001913,875,875,0,875,750,125,1913,1913,0,0,1913,1858,1661,120,7,7,5,58,55,54,1,0,0,0,1913,157,1756,1913,919,994,1661,42,071,011200
42,011300,0000002643845,00004060,1741,1741,0,1741,1670,71,4060,4060,0,0,4060,3995,3834,110,5,13,0,33,65,63,2,0,0,0,4060,108,3952,4060,1890,2170,3834,42,071,011300
42,011400,0000002604036,00004338,1979,1979,0,1979,1867,112,4338,4338,0,0,4338,4262,3923,226,7,22,0,84,76,73,3,0,0,0,4338,198,4140,4338,2054,2284,3923,42,071,011400
42,011502,0000020688336,00005430,2081,2081,0,2081,2010,71,5430,5430,0,0,5430,5343,4881,148,5,66,1,242,87,79,8,0,0,0,5430,449,4981,5430,2657,2773,4881,42,071,011502
42,011503,0000006484517,00004826,1867,1867,0,1867,1842,25,4826,4826,0,0,4826,4779,4535,85,7,103,0,49,47,47,0,0,0,0,4826,166,4660,4826,2338,2488,4535,42,071,011503
42,011504,0000023793632,00007304,2628,2628,0,2628,2586,42,7304,7304,0,0,7304,7234,7004,82,3,88,0,57,70,66,4,0,0,0,7304,142,7162,7304,3512,3792,7004,42,071,011504
42,011600,0000024518860,00005782,2233,2233,0,2233,2169,64,5782,5782,0,0,5782,5721,5528,69,7,56,4,57,61,54,7,0,0,0,5782,138,5644,5782,2816,2966,5528,42,071,011600
42,011701,0000008964414,00004412,1989,1989,0,1989,1923,66,4412,4412,0,0,4412,4368,4157,61,3,101,0,46,44,42,2,0,0,0,4412,104,4308,4412,2080,2332,4157,42,071,011701
42,011702,0000012812394,00008008,3528,3528,0,3528,3423,105,8008,8008,0,0,8008,7919,7160,198,19,299,0,243,89,82,7,0,0,0,8008,388,7620,8008,3963,4045,7160,42,071,011702
42,011703,0000011616493,00007647,2777,2777,0,2777,2745,32,7647,7647,0,0,7647,7608,7381,56,1,141,0,29,39,38,1,0,0,0,7647,92,7555,7647,3809,3838,7381,42,071,011703
42,011801,0000004808214,00002908,1116,1116,0,1116,1083,33,2908,2908,0,0,2908,2894,2795,35,2,56,0,6,14,14,0,0,0,0,2908,32,2876,2908,1420,1488,2795,42,071,011801
42,011802,0000004206486,00005422,2386,2386,0,2386,2320,66,5422,5422,0,0,5422,5341,5016,110,7,144,0,64,81,76,5,0,0,0,5422,158,5264,5422,2502,2920,5016,42,071,011802
42,011803,0000006850336,00005328,2607,2607,0,2607,2465,142,5328,5328,0,0,5328,5282,5042,42,4,157,0,37,46,41,5,0,0,0,5328,122,5206,5328,2419,2909,5042,42,071,011803
42,011804,0000010750798,00007657,2895,2895,0,2895,2841,54,7657,7657,0,0,7657,7577,7070,101,1,337,1,67,80,69,11,0,0,0,7657,198,7459,7657,3750,3907,7070,42,071,011804
42,011805,0000008190770,00002370,824,824,0,824,778,46,2370,2370,0,0,2370,2325,2006,94,10,97,0,118,45,36,9,0,0,0,2370,205,2165,2370,1057,1313,2006,42,071,011805
42,011900,0000031858475,00009953,3593,3593,0,3593,3466,127,9953,9953,0,0,9953,9849,9401,124,11,252,1,60,104,101,3,0,0,0,9953,221,9732,9953,4608,5345,9401,42,071,011900
42,012001,0000002976630,00005155,2189,2189,0,2189,2142,47,5155,5155,0,0,5155,5121,5015,24,2,48,3,29,34,32,2,0,0,0,5155,82,5073,5155,2357,2798,5015,42,071,012001
42,012002,0000003044271,00003874,1638,1638,0,1638,1590,48,3874,3874,0,0,3874,3833,3764,16,6,31,0,16,41,40,1,0,0,0,3874,55,3819,3874,1827,2047,3764,42,071,012002
42,012101,0000029076700,00008376,3018,3018,0,3018,2942,76,8376,8376,0,0,8376,8294,8146,51,8,50,6,33,82,78,3,1,0,0,8376,142,8234,8376,4151,4225,8146,42,071,012101
42,012102,0000022184784,00007099,2689,2689,0,2689,2626,63,7099,7099,0,0,7099,7049,6903,24,6,82,1,33,50,49,1,0,0,0,7099,99,7000,7099,3495,3604,6903,42,071,012102
42,012200,0000003608453,00006905,2923,2923,0,2923,2820,103,6905,6905,0,0,6905,6842,6630,34,16,87,7,68,63,56,7,0,0,0,6905,230,6675,6905,3423,3482,6630,42,071,012200
42,012301,0000002496697,00003238,1426,1426,0,1426,1376,50,3238,3238,0,0,3238,3207,3129,16,8,26,11,17,31,30,1,0,0,0,3238,55,3183,3238,1553,1685,3129,42,071,012301
42,012302,0000003110636,00002986,1280,1280,0,1280,1242,38,2986,2986,0,0,2986,2951,2856,34,10,27,0,24,35,32,3,0,0,0,2986,79,2907,2986,1444,1542,2856,42,071,012302
42,012401,0000042142075,00008110,2790,2790,0,2790,2730,60,8110,8110,0,0,8110,8052,7803,35,7,146,0,61,58,58,0,0,0,0,8110,142,7968,8110,3981,4129,7803,42,071,012401
42,012402,0000003274935,00004046,1687,1687,0,1687,1622,65,4046,4046,0,0,4046,4020,3901,22,9,56,0,32,26,25,1,0,0,0,4046,90,3956,4046,1915,2131,3901,42,071,012402
42,012501,0000035577464,00006441,2415,2415,0,2415,2340,75,6441,6441,0,0,6441,6397,6202,38,0,133,1,23,44,36,8,0,0,0,6441,60,6381,6441,3238,3203,6202,42,071,012501
42,012502,0000021334389,00004714,1674,1674,0,1674,1621,53,4714,4714,0,0,4714,4669,4521,10,11,91,2,34,45,42,3,0,0,0,4714,88,4626,4714,2330,2384,4521,42,071,012502
42,012601,0000064537622,00006699,2161,2161,0,2161,2115,46,6699,6699,0,0,6699,6649,6545,22,10,50,2,20,50,50,0,0,0,0,6699,64,6635,6699,3379,3320,6545,42,071,012601
42,012602,0000059517523,00004278,1303,1303,0,1303,1269,34,4278,4278,0,0,4278,4269,4231,21,4,11,0,2,9,8,1,0,0,0,4278,28,4250,4278,2118,2160,4231,42,071,012602
42,012700,0000064910478,00006960,2249,2249,0,2249,2178,71,6960,6960,0,0,6960,6916,6838,35,4,21,2,16,44,44,0,0,0,0,6960,61,6899,6960,3482,3478,6838,42,071,012700
42,012800,0000005395782,00005092,2159,2159,0,2159,2084,75,5092,5092,0,0,5092,5007,4600,52,4,219,1,131,85,81,3,1,0,0,5092,327,4765,5092,2485,2607,4600,42,071,012800
42,012900,0000056853333,00006183,2126,2126,0,2126,2019,107,6183,6183,0,0,6183,6134,6014,37,0,71,0,12,49,46,3,0,0,0,6183,66,6117,6183,2968,3215,6014,42,071,012900
42,013000,0000045699458,00006766,2283,2283,0,2283,2201,82,6766,6766,0,0,6766,6742,6538,24,4,144,0,32,24,24,0,0,0,0,6766,102,6664,6766,3306,3460,6538,42,071,013000
42,013101,0000027830201,00004692,1675,1675,0,1675,1635,40,4692,4692,0,0,4692,4639,4362,75,5,135,0,62,53,53,0,0,0,0,4692,179,4513,4692,2319,2373,4362,42,071,013101
42,013102,0000018800509,00003537,1179,1179,0,1179,1142,37,3537,3537,0,0,3537,3485,3237,27,7,170,0,44,52,50,2,0,0,0,3537,88,3449,3537,1757,1780,3237,42,071,013102
42,013202,0000006976242,00004404,1921,1921,0,1921,1846,75,4404,4404,0,0,4404,4333,3931,141,3,117,4,137,71,66,5,0,0,0,4404,264,4140,4404,2117,2287,3931,42,071,013202
42,013203,0000018377831,00004192,1729,1729,0,1729,1662,67,4192,4192,0,0,4192,4155,3994,39,3,89,1,29,37,33,2,0,2,0,4192,87,4105,4192,2074,2118,3994,42,071,013203
42,013204,0000027983122,00005861,2370,2370,0,2370,2235,135,5861,5861,0,0,5861,5804,5383,133,3,167,0,118,57,47,8,2,0,0,5861,244,5617,5861,2902,2959,5383,42,071,013204
42,013301,0000008910428,00003661,1437,1437,0,1437,1393,44,3661,3661,0,0,3661,3627,3437,78,3,46,0,63,34,28,6,0,0,0,3661,120,3541,3661,1808,1853,3437,42,071,013301
42,013302,0000035697410,00010536,4400,4400,0,4400,4254,146,10536,10536,0,0,10536,10487,10318,63,3,54,1,48,49,49,0,0,0,0,10536,163,10373,10536,4857,5679,10318,42,071,013302
42,013400,0000002094828,00002106,928,928,0,928,877,51,2106,2106,0,0,2106,2032,1652,195,8,48,0,129,74,65,9,0,0,0,2106,241,1865,2106,1032,1074,1652,42,071,013400
42,013501,0000008941709,00007195,3146,3146,0,3146,3043,103,7195,7195,0,0,7195,7025,5668,640,7,157,0,553,170,160,9,1,0,0,7195,955,6240,7195,3307,3888,5668,42,071,013501
42,013502,0000003571960,00004495,1999,1999,0,1999,1938,61,4495,4495,0,0,4495,4434,4148,137,3,90,1,55,61,58,3,0,0,0,4495,198,4297,4495,2032,2463,4148,42,071,013502
42,013503,0000002386335,00002497,1094,1094,0,1094,1066,28,2497,2497,0,0,2497,2488,2399,15,1,48,0,25,9,8,1,0,0,0,2497,50,2447,2497,1192,1305,2399,42,071,013503
42,013601,0000002346336,00001458,625,625,0,625,609,16,1458,1458,0,0,1458,1449,1407,8,2,14,0,18,9,9,0,0,0,0,1458,36,1422,1458,678,780,1407,42,071,013601
42,013602,0000004272318,00005921,1625,1625,0,1625,1511,114,5921,5921,0,0,5921,5869,5430,314,2,65,6,52,52,49,3,0,0,0,5921,124,5797,5921,2706,3215,5430,42,071,013602
42,013701,0000004803138,00004228,1919,1919,0,1919,1835,84,4228,4228,0,0,4228,4166,3953,89,4,59,1,60,62,61,1,0,0,0,4228,148,4080,4228,1994,2234,3953,42,071,013701
42,013702,0000027426030,00007316,2930,2930,0,2930,2827,103,7316,7316,0,0,7316,7248,6969,110,8,111,1,49,68,63,5,0,0,0,7316,178,7138,7316,3558,3758,6969,42,071,013702
42,013800,0000065683853,00003924,1415,1415,0,1415,1383,32,3924,3924,0,0,3924,3915,3872,10,4,15,0,14,9,9,0,0,0,0,3924,41,3883,3924,2015,1909,3872,42,071,013800
42,013901,0000035239533,00004358,1626,1626,0,1626,1581,45,4358,4358,0,0,4358,4323,4258,21,2,27,2,13,35,35,0,0,0,0,4358,45,4313,4358,2181,2177,4258,42,071,013901
42,013902,0000037878274,00003749,1409,1409,0,1409,1374,35,3749,3749,0,0,3749,3722,3686,12,5,6,8,5,27,26,0,1,0,0,3749,37,3712,3749,1892,1857,3686,42,071,013902
42,014000,0000054462610,00006821,2430,2430,0,2430,2385,45,6821,6821,0,0,6821,6776,6713,24,3,28,2,6,45,37,2,1,5,0,6821,22,6799,6821,3382,3439,6713,42,071,014000
42,014101,0000053522610,00004878,1476,1476,0,1476,1426,50,4878,4878,0,0,4878,4855,4786,20,6,35,1,7,23,23,0,0,0,0,4878,29,4849,4878,2454,2424,4786,42,071,014101
42,014102,0000048216563,00004698,1600,1600,0,1600,1554,46,4698,4698,0,0,4698,4671,4621,29,5,5,3,8,27,26,1,0,0,0,4698,34,4664,4698,2384,2314,4621,42,071,014102
42,014201,0000059119335,00005082,1484,1484,0,1484,1449,35,5082,5082,0,0,5082,5037,4943,56,7,14,0,17,45,41,4,0,0,0,5082,51,5031,5082,2608,2474,4943,42,071,014201
42,014202,0000049285811,00004930,1628,1628,0,1628,1578,50,4930,4930,0,0,4930,4897,4816,20,5,35,4,17,33,32,1,0,0,0,4930,57,4873,4930,2461,2469,4816,42,071,014202
42,014300,0000094431517,00007152,2126,2126,0,2126,2083,43,7152,7152,0,0,7152,7119,7036,53,12,10,0,8,33,33,0,0,0,0,7152,61,7091,7152,3548,3604,7036,42,071,014300
42,014401,0000052156533,00006651,2486,2486,0,2486,2387,99,6651,6651,0,0,6651,6591,6501,41,11,14,1,23,60,57,3,0,0,0,6651,61,6590,6651,3306,3345,6501,42,071,014401
42,014402,0000035575831,00003850,1470,1470,0,1470,1416,54,3850,3850,0,0,3850,3822,3762,18,2,7,1,32,28,28,0,0,0,0,3850,63,3787,3850,1874,1976,3762,42,071,014402
42,014501,0000075157842,00004990,1789,1789,0,1789,1713,76,4990,4990,0,0,4990,4961,4906,24,12,8,1,10,29,29,0,0,0,0,4990,68,4922,4990,2588,2402,4906,42,071,014501
42,014502,0000129019940,00005069,1862,1862,0,1862,1671,191,5069,5069,0,0,5069,5037,4969,42,3,8,0,15,32,31,1,0,0,0,5069,50,5019,5069,2557,2512,4969,42,071,014502
42,014601,0000060139163,00003535,1079,1079,0,1079,1055,24,3535,3535,0,0,3535,3523,3477,16,1,5,2,22,12,11,1,0,0,0,3535,29,3506,3535,1674,1861,3477,42,071,014601
42,014602,0000145510785,00006775,2145,2145,0,2145,2079,66,6775,6775,0,0,6775,6720,6638,45,2,12,0,23,55,53,2,0,0,0,6775,72,6703,6775,3410,3365,6638,42,071,014602
42,000100,0000002831192,00004585,2080,2080,0,2080,1950,130,4585,4585,0,0,4585,4552,4469,66,0,13,0,4,33,33,0,0,0,0,4585,17,4568,4585,2134,2451,4469,42,073,000100
42,000200,0000003268198,00002317,1020,1020,0,1020,959,61,2317,2317,0,0,2317,2289,2133,149,3,0,0,4,28,26,2,0,0,0,2317,28,2289,2317,1049,1268,2133,42,073,000200
42,000300,0000002208358,00004291,1965,1965,0,1965,1756,209,4291,4291,0,0,4291,4189,3530,629,2,8,1,19,102,94,7,1,0,0,4291,49,4242,4291,1933,2358,3530,42,073,000300
42,000400,0000002686057,00002420,1200,1200,0,1200,1052,148,2420,2420,0,0,2420,2320,1100,1194,5,8,0,13,100,89,10,1,0,0,2420,23,2397,2420,1018,1402,1100,42,073,000400
42,000600,0000000530946,00001608,550,550,0,550,476,74,1608,1608,0,0,1608,1553,1388,152,3,5,1,4,55,55,0,0,0,0,1608,18,1590,1608,857,751,1388,42,073,000600
42,000700,0000001053228,00002312,963,963,0,963,867,96,2312,2312,0,0,2312,2285,2121,145,4,3,0,12,27,27,0,0,0,0,2312,23,2289,2312,1047,1265,2121,42,073,000700
42,000800,0000002158096,00004641,2043,2043,0,2043,1941,102,4641,4641,0,0,4641,4592,4408,163,4,6,0,11,49,49,0,0,0,0,4641,20,4621,4641,2191,2450,4408,42,073,000800
42,000900,0000001853169,00002184,1010,1010,0,1010,913,97,2184,2184,0,0,2184,2112,1772,328,3,1,0,8,72,70,2,0,0,0,2184,9,2175,2184,973,1211,1772,42,073,000900
42,001000,0000004779770,00001951,878,878,0,878,813,65,1951,1951,0,0,1951,1930,1908,13,4,2,0,3,21,21,0,0,0,0,1951,12,1939,1951,912,1039,1908,42,073,001000
42,010100,0000140048079,00003916,1599,1599,0,1599,1444,155,3916,3916,0,0,3916,3895,3876,2,9,8,0,0,21,20,1,0,0,0,3916,11,3905,3916,1962,1954,3876,42,073,010100
42,010200,0000116095463,00008171,3358,3358,0,3358,3203,155,8171,8171,0,0,8171,8131,8027,31,7,55,5,6,40,40,0,0,0,0,8171,44,8127,8171,3931,4240,8027,42,073,010200
42,010300,0000002745370,00002452,611,611,0,611,577,34,2452,2452,0,0,2452,2444,2408,14,5,11,0,6,8,5,1,2,0,0,2452,11,2441,2452,937,1515,2408,42,073,010300
42,010400,0000078925505,00003658,1358,1358,0,1358,1292,66,3658,3658,0,0,3658,3646,3620,10,3,5,0,8,12,12,0,0,0,0,3658,11,3647,3658,1758,1900,3620,42,073,010400
42,010500,0000063585607,00003447,1436,1436,0,1436,1373,63,3447,3447,0,0,3447,3431,3407,10,4,6,0,4,16,16,0,0,0,0,3447,12,3435,3447,1688,1759,3407,42,073,010500
42,010600,0000020428945,00002289,1010,1010,0,1010,959,51,2289,2289,0,0,2289,2288,2247,30,1,4,0,6,1,1,0,0,0,0,2289,10,2279,2289,1082,1207,2247,42,073,010600
42,010700,0000004859251,00002866,1241,1241,0,1241,1184,57,2866,2866,0,0,2866,2839,2648,178,0,4,0,9,27,27,0,0,0,0,2866,17,2849,2866,1378,1488,2648,42,073,010700
42,010800,0000022305638,00006161,2593,2593,0,2593,2481,112,6161,6161,0,0,6161,6140,6075,10,5,48,1,1,21,21,0,0,0,0,6161,20,6141,6161,2833,3328,6075,42,073,010800
42,010900,0000078024162,00003179,1285,1285,0,1285,1203,82,3179,3179,0,0,3179,3169,3153,2,6,4,0,4,10,10,0,0,0,0,3179,12,3167,3179,1579,1600,3153,42,073,010900
42,011000,0000032977810,00005109,1979,1979,0,1979,1895,84,5109,5109,0,0,5109,5089,4944,113,1,5,1,25,20,20,0,0,0,0,5109,47,5062,5109,2613,2496,4944,42,073,011000
42,011100,0000044724120,00004478,1825,1825,0,1825,1720,105,4478,4478,0,0,4478,4462,4403,36,9,4,0,10,16,15,1,0,0,0,4478,15,4463,4478,2196,2282,4403,42,073,011100
42,011200,0000036669764,00002584,1073,1073,0,1073,1019,54,2584,2584,0,0,2584,2569,2547,8,0,12,0,2,15,15,0,0,0,0,2584,17,2567,2584,1263,1321,2547,42,073,011200
42,011300,0000135228132,00004307,1654,1654,0,1654,1552,102,4307,4307,0,0,4307,4279,4260,5,1,10,0,3,28,27,1,0,0,0,4307,23,4284,4307,2131,2176,4260,42,073,011300
42,011400,0000039862187,00002355,1006,1006,0,1006,942,64,2355,2355,0,0,2355,2348,2305,36,3,3,0,1,7,7,0,0,0,0,2355,15,2340,2355,1161,1194,2305,42,073,011400
42,011500,0000088773590,00003822,1532,1532,0,1532,1454,78,3822,3822,0,0,3822,3801,3772,15,4,10,0,0,21,20,1,0,0,0,3822,15,3807,3822,1928,1894,3772,42,073,011500
42,011600,0000002984601,00004462,1913,1913,0,1913,1833,80,4462,4462,0,0,4462,4442,4402,24,4,8,0,4,20,14,6,0,0,0,4462,23,4439,4462,2086,2376,4402,42,073,011600
42,011700,0000002517655,00002179,969,969,0,969,915,54,2179,2179,0,0,2179,2168,2140,13,2,12,0,1,11,11,0,0,0,0,2179,7,2172,2179,1032,1147,2140,42,073,011700
42,011800,0000001464017,00002899,1484,1484,0,1484,1318,166,2899,2899,0,0,2899,2885,2831,40,3,3,0,8,14,14,0,0,0,0,2899,20,2879,2899,1322,1577,2831,42,073,011800
42,000100,0000001600239,00004693,2356,2356,0,2356,2104,252,4693,4693,0,0,4693,4633,4181,165,5,50,6,226,60,56,3,1,0,0,4693,454,4239,4693,2383,2310,4181,42,075,000100
42,000200,0000002554867,00004690,2306,2306,0,2306,2127,179,4690,4690,0,0,4690,4642,4255,123,12,51,12,189,48,46,2,0,0,0,4690,379,4311,4690,2219,2471,4255,42,075,000200
42,000300,0000002033589,00004166,1742,1742,0,1742,1557,185,4166,4166,0,0,4166,4024,2964,211,23,57,0,769,142,139,2,1,0,0,4166,1398,2768,4166,2066,2100,2964,42,075,000300
42,000400,0000002679813,00007383,3234,3234,0,3234,2986,248,7383,7383,0,0,7383,7256,6400,191,23,61,5,576,127,123,4,0,0,0,7383,1275,6108,7383,3523,3860,6400,42,075,000400
42,000500,0000001970782,00003529,1582,1582,0,1582,1492,90,3529,3529,0,0,3529,3476,3115,100,6,30,2,223,53,50,3,0,0,0,3529,513,3016,3529,1666,1863,3115,42,075,000500
42,002000,0000140500144,00002639,1130,1130,0,1130,1036,94,2639,2639,0,0,2639,2619,2591,5,6,8,0,9,20,20,0,0,0,0,2639,24,2615,2639,1351,1288,2591,42,075,002000
42,002100,0000089931656,00004526,1710,1710,0,1710,1608,102,4526,4526,0,0,4526,4505,4442,12,5,11,0,35,21,21,0,0,0,0,4526,70,4456,4526,2302,2224,4442,42,075,002100
42,002200,0000056503807,00004969,1905,1905,0,1905,1834,71,4969,4969,0,0,4969,4943,4839,57,9,25,0,13,26,26,0,0,0,0,4969,58,4911,4969,2533,2436,4839,42,075,002200
42,002300,0000084524330,00002858,1091,1091,0,1091,1034,57,2858,2858,0,0,2858,2832,2767,18,7,15,1,24,26,26,0,0,0,0,2858,64,2794,2858,1451,1407,2767,42,075,002300
42,002400,0000045108553,00002279,861,861,0,861,828,33,2279,2279,0,0,2279,2264,2256,0,4,2,1,1,15,15,0,0,0,0,2279,17,2262,2279,1124,1155,2256,42,075,002400
42,002500,0000004084875,00004518,1556,1556,0,1556,1452,104,4518,4518,0,0,4518,4465,4310,49,1,56,5,44,53,53,0,0,0,0,4518,81,4437,4518,2116,2402,4310,42,075,002500
42,002600,0000002256994,00002148,913,913,0,913,879,34,2148,2148,0,0,2148,2130,2074,22,1,26,1,6,18,17,1,0,0,0,2148,29,2119,2148,1057,1091,2074,42,075,002600
42,002701,0000023194698,00005372,2069,2069,0,2069,1991,78,5372,5372,0,0,5372,5333,5175,30,8,85,0,35,39,34,4,1,0,0,5372,133,5239,5372,2624,2748,5175,42,075,002701
42,002702,0000020568108,00005257,2165,2165,0,2165,2081,84,5257,5257,0,0,5257,5199,4871,88,5,39,0,196,58,55,3,0,0,0,5257,437,4820,5257,2569,2688,4871,42,075,002702
42,002800,0000061625206,00006338,2478,2478,0,2478,2397,81,6338,6338,0,0,6338,6316,6249,18,6,23,1,19,22,20,2,0,0,0,6338,48,6290,6338,3059,3279,6249,42,075,002800
42,002900,0000002307586,00003171,1339,1339,0,1339,1265,74,3171,3171,0,0,3171,3158,3091,46,0,14,0,7,13,11,2,0,0,0,3171,30,3141,3171,1464,1707,3091,42,075,002900
42,003000,0000056772276,00004429,1692,1692,0,1692,1625,67,4429,4429,0,0,4429,4397,4338,27,0,10,0,22,32,32,0,0,0,0,4429,46,4383,4429,2203,2226,4338,42,075,003000
42,003100,0000062634106,00003832,1389,1389,0,1389,1346,43,3832,3832,0,0,3832,3825,3805,8,0,7,0,5,7,6,1,0,0,0,3832,14,3818,3832,1918,1914,3805,42,075,003100
42,003200,0000047529109,00003335,1222,1222,0,1222,1195,27,3335,3335,0,0,3335,3312,3201,37,1,47,0,26,23,22,1,0,0,0,3335,64,3271,3335,1626,1709,3201,42,075,003200
42,003300,0000003806488,00002619,798,798,0,798,749,49,2619,2619,0,0,2619,2602,2484,52,5,14,1,46,17,17,0,0,0,0,2619,148,2471,2619,1312,1307,2484,42,075,003300
42,003400,0000005043774,00002429,1010,1010,0,1010,976,34,2429,2429,0,0,2429,2415,2340,43,2,19,0,11,14,14,0,0,0,0,2429,43,2386,2429,1242,1187,2340,42,075,003400
42,003500,0000023643595,00004205,1670,1670,0,1670,1572,98,4205,4205,0,0,4205,4163,3957,47,3,111,4,41,42,42,0,0,0,0,4205,109,4096,4205,2012,2193,3957,42,075,003500
42,003600,0000002045784,00003034,1280,1280,0,1280,1228,52,3034,3034,0,0,3034,2969,2748,61,7,39,0,114,65,60,5,0,0,0,3034,251,2783,3034,1443,1591,2748,42,075,003600
42,003700,0000050892905,00002946,1129,1129,0,1129,1095,34,2946,2946,0,0,2946,2933,2884,11,1,22,0,15,13,13,0,0,0,0,2946,37,2909,2946,1443,1503,2884,42,075,003700
42,003800,0000027991824,00006771,2782,2782,0,2782,2716,66,6771,6771,0,0,6771,6729,6621,9,0,85,0,14,42,33,4,5,0,0,6771,86,6685,6771,3199,3572,6621,42,075,003800
42,003900,0000004818316,00007096,3363,3363,0,3363,3200,163,7096,7096,0,0,7096,7025,6863,64,8,65,1,24,71,71,0,0,0,0,7096,85,7011,7096,3327,3769,6863,42,075,003900
42,004000,0000062322350,00005458,2138,2138,0,2138,2062,76,5458,5458,0,0,5458,5422,5341,29,2,39,0,11,36,33,3,0,0,0,5458,32,5426,5458,2663,2795,5341,42,075,004000
42,004100,0000022986134,00002151,1149,1149,0,1149,906,243,2151,2151,0,0,2151,2130,2091,13,0,19,3,4,21,21,0,0,0,0,2151,18,2133,2151,1067,1084,2091,42,075,004100
42,004200,0000025272858,00003486,1261,1261,0,1261,1210,51,3486,3486,0,0,3486,3476,3409,12,7,37,0,11,10,9,1,0,0,0,3486,26,3460,3486,1648,1838,3409,42,075,004200
42,000100,0000005300660,00007412,3407,3407,0,3407,3086,321,7412,7412,0,0,7412,7109,5968,409,11,223,10,488,303,285,17,1,0,0,7412,966,6446,7412,3568,3844,5968,42,077,000100
42,000200,0000001713139,00000589,230,230,0,230,217,13,589,589,0,0,589,582,518,40,3,0,0,21,7,7,0,0,0,0,589,64,525,589,296,293,518,42,077,000200
42,000300,0000002557291,00006867,2804,2804,0,2804,2641,163,6867,6867,0,0,6867,6523,4627,632,20,80,8,1156,344,339,5,0,0,0,6867,2344,4523,6867,3278,3589,4627,42,077,000300
42,000400,0000000956995,00003431,1278,1278,0,1278,1180,98,3431,3431,0,0,3431,3140,2188,184,22,108,3,635,291,282,9,0,0,0,3431,1181,2250,3431,1649,1782,2188,42,077,000400
42,000500,0000001060348,00002252,795,795,0,795,684,111,2252,2252,0,0,2252,2113,963,338,19,27,0,766,139,125,12,2,0,0,2252,1336,916,2252,1147,1105,963,42,077,000500
42,000600,0000002559017,00005766,2227,2227,0,2227,2131,96,5766,5766,0,0,5766,5622,4039,358,20,171,5,1029,144,142,2,0,0,0,5766,1609,4157,5766,2756,3010,4039,42,077,000600
42,000700,0000000832418,00003449,1302,1302,0,1302,1167,135,3449,3449,0,0,3449,3265,1979,415,22,74,10,765,184,180,4,0,0,0,3449,1391,2058,3449,1666,1783,1979,42,077,000700
42,000800,0000000311529,00003615,1388,1388,0,1388,1144,244,3615,3615,0,0,3615,3424,1742,400,22,82,0,1178,191,188,3,0,0,0,3615,1873,1742,3615,1856,1759,1742,42,077,000800
42,000900,0000000227858,00001655,669,669,0,669,544,125,1655,1655,0,0,1655,1584,803,186,11,28,4,552,71,67,4,0,0,0,1655,939,716,1655,789,866,803,42,077,000900
42,001000,0000000314051,00002819,1251,1251,0,1251,964,287,2819,2819,0,0,2819,2675,1283,425,35,33,0,899,144,143,1,0,0,0,2819,1639,1180,2819,1344,1475,1283,42,077,001000
42,001100,0000000363330,00000882,564,564,0,564,398,166,882,882,0,0,882,849,494,129,6,1,0,219,33,33,0,0,0,0,882,403,479,882,479,403,494,42,077,001100
42,001200,0000000377801,00002213,641,641,0,641,575,66,2213,2213,0,0,2213,2125,1188,530,11,60,0,336,88,86,2,0,0,0,2213,819,1394,2213,1484,729,1188,42,077,001200
42,001300,0000000565987,00002047,1104,1104,0,1104,937,167,2047,2047,0,0,2047,1965,1228,272,8,18,0,439,82,80,2,0,0,0,2047,858,1189,2047,950,1097,1228,42,077,001300
42,001401,0000003166901,00006398,3004,3004,0,3004,2775,229,6398,6398,0,0,6398,6191,5095,417,23,201,5,450,207,194,10,3,0,0,6398,928,5470,6398,3126,3272,5095,42,077,001401
42,001402,0000004731312,00002146,1006,1006,0,1006,968,38,2146,2146,0,0,2146,2118,1999,43,6,39,0,31,28,23,5,0,0,0,2146,93,2053,2146,1011,1135,1999,42,077,001402
42,001501,0000003547508,00006033,2598,2598,0,2598,2472,126,6033,6033,0,0,6033,5843,4206,469,20,225,6,917,190,181,8,1,0,0,6033,1678,4355,6033,2957,3076,4206,42,077,001501
42,001502,0000003080871,00006042,2865,2865,0,2865,2689,176,6042,6042,0,0,6042,5919,4949,402,9,265,2,292,123,120,3,0,0,0,6042,527,5515,6042,2985,3057,4949,42,077,001502
42,001600,0000000331109,00003259,1282,1282,0,1282,1128,154,3259,3259,0,0,3259,3058,1876,414,2,50,9,707,201,183,17,1,0,0,3259,1301,1958,3259,1563,1696,1876,42,077,001600
42,001700,0000000468090,00004006,1591,1591,0,1591,1446,145,4006,4006,0,0,4006,3822,2647,348,16,110,6,695,184,180,4,0,0,0,4006,1296,2710,4006,1928,2078,2647,42,077,001700
42,001800,0000000538669,00004043,1944,1944,0,1944,1629,315,4043,4043,0,0,4043,3863,2453,517,15,15,0,863,180,170,9,1,0,0,4043,1559,2484,4043,1982,2061,2453,42,077,001800
42,001900,0000001364329,00004001,1926,1926,0,1926,1842,84,4001,4001,0,0,4001,3928,3400,178,5,40,4,301,73,70,3,0,0,0,4001,537,3464,4001,1721,2280,3400,42,077,001900
42,002000,0000000554986,00004479,2104,2104,0,2104,1881,223,4479,4479,0,0,4479,4320,3120,449,12,47,2,690,159,142,17,0,0,0,4479,1119,3360,4479,2171,2308,3120,42,077,002000
42,002100,0000001224752,00006075,3013,3013,0,3013,2842,171,6075,6075,0,0,6075,5875,4643,473,27,191,1,540,200,183,17,0,0,0,6075,1003,5072,6075,2803,3272,4643,42,077,002100
42,002201,0000001271689,00004410,2090,2090,0,2090,2008,82,4410,4410,0,0,4410,4351,4143,94,2,57,1,54,59,59,0,0,0,0,4410,170,4240,4410,2052,2358,4143,42,077,002201
42,002202,0000001283763,00004017,1004,1004,0,1004,971,33,4017,4017,0,0,4017,3952,3675,102,6,43,0,126,65,62,3,0,0,0,4017,193,3824,4017,1584,2433,3675,42,077,002202
42,002301,0000004970516,00005686,2661,2661,0,2661,2530,131,5686,5686,0,0,5686,5644,5316,73,0,190,0,65,42,41,1,0,0,0,5686,139,5547,5686,2673,3013,5316,42,077,002301
42,002302,0000002267067,00003040,1212,1212,0,1212,1183,29,3040,3040,0,0,3040,2986,2819,73,3,43,2,46,54,52,2,0,0,0,3040,93,2947,3040,1219,1821,2819,42,077,002302
42,005100,0000003423394,00004434,1867,1867,0,1867,1743,124,4434,4434,0,0,4434,4391,4267,63,9,17,1,34,43,42,1,0,0,0,4434,90,4344,4434,2157,2277,4267,42,077,005100
42,005200,0000061282984,00006588,2594,2594,0,2594,2512,82,6588,6588,0,0,6588,6565,6503,14,5,27,0,16,23,18,5,0,0,0,6588,64,6524,6588,3342,3246,6503,42,077,005200
42,005300,0000171314961,00007128,2687,2687,0,2687,2584,103,7128,7128,0,0,7128,7077,7011,18,6,19,0,23,51,46,5,0,0,0,7128,72,7056,7128,3618,3510,7011,42,077,005300
42,005400,0000105704422,00006013,2217,2217,0,2217,2135,82,6013,6013,0,0,6013,5963,5890,28,3,24,0,18,50,49,1,0,0,0,6013,71,5942,6013,3030,2983,5890,42,077,005400
42,005501,0000050569190,00007839,2888,2888,0,2888,2751,137,7839,7839,0,0,7839,7771,7652,42,5,43,1,28,68,67,1,0,0,0,7839,105,7734,7839,3979,3860,7652,42,077,005501
42,005502,0000023297628,00006892,2585,2585,0,2585,2499,86,6892,6892,0,0,6892,6823,6613,81,8,63,1,57,69,64,5,0,0,0,6892,139,6753,6892,3346,3546,6613,42,077,005502
42,005601,0000014771526,00004522,1776,1776,0,1776,1744,32,4522,4522,0,0,4522,4501,4389,51,3,37,2,19,21,21,0,0,0,0,4522,75,4447,4522,2165,2357,4389,42,077,005601
42,005602,0000005347700,00005199,2180,2180,0,2180,2117,63,5199,5199,0,0,5199,5171,5006,70,6,48,4,37,28,28,0,0,0,0,5199,130,5069,5199,2514,2685,5006,42,077,005602
42,005701,0000007271512,00007537,3283,3283,0,3283,3156,127,7537,7537,0,0,7537,7428,6419,233,6,613,7,150,109,105,4,0,0,0,7537,366,7171,7537,3666,3871,6419,42,077,005701
42,005702,0000003362572,00004119,1962,1962,0,1962,1874,88,4119,4119,0,0,4119,4082,3961,55,0,40,0,26,37,37,0,0,0,0,4119,105,4014,4119,1896,2223,3961,42,077,005702
42,005703,0000001793820,00003519,1543,1543,0,1543,1485,58,3519,3519,0,0,3519,3421,2770,273,17,164,3,194,98,89,9,0,0,0,3519,413,3106,3519,1690,1829,2770,42,077,005703
42,005800,0000001632632,00003387,1484,1484,0,1484,1431,53,3387,3387,0,0,3387,3365,3280,53,3,11,0,18,22,20,2,0,0,0,3387,77,3310,3387,1568,1819,3280,42,077,005800
42,005901,0000003277738,00006588,2747,2747,0,2747,2616,131,6588,6588,0,0,6588,6509,6298,78,22,39,1,71,79,75,4,0,0,0,6588,233,6355,6588,3193,3395,6298,42,077,005901
42,005902,0000010898640,00001913,937,937,0,937,892,45,1913,1913,0,0,1913,1883,1648,106,1,90,0,38,30,28,2,0,0,0,1913,117,1796,1913,939,974,1648,42,077,005902
42,006001,0000011383882,00004613,1872,1872,0,1872,1831,41,4613,4613,0,0,4613,4579,4449,58,2,52,0,18,34,33,1,0,0,0,4613,65,4548,4613,2212,2401,4449,42,077,006001
42,006002,0000022688842,00005107,1884,1884,0,1884,1825,59,5107,5107,0,0,5107,5068,4833,47,0,169,0,19,39,37,1,1,0,0,5107,74,5033,5107,2521,2586,4833,42,077,006002
42,006101,0000006384209,00004016,1501,1501,0,1501,1431,70,4016,4016,0,0,4016,3988,3824,43,3,90,0,28,28,28,0,0,0,0,4016,93,3923,4016,1561,2455,3824,42,077,006101
42,006102,0000003892456,00004292,1897,1897,0,1897,1856,41,4292,4292,0,0,4292,4255,4141,36,1,62,0,15,37,34,3,0,0,0,4292,40,4252,4292,2018,2274,4141,42,077,006102
42,006201,0000029846851,00009203,3318,3318,0,3318,3208,110,9203,9203,0,0,9203,9104,8421,118,4,503,0,58,99,92,2,0,5,0,9203,175,9028,9203,4433,4770,8421,42,077,006201
42,006202,0000038114762,00004692,2017,2017,0,2017,1920,97,4692,4692,0,0,4692,4652,4496,46,1,85,0,24,40,36,4,0,0,0,4692,60,4632,4692,2260,2432,4496,42,077,006202
42,006302,0000025657692,00003641,1468,1468,0,1468,1409,59,3641,3641,0,0,3641,3614,3532,12,3,42,5,20,27,27,0,0,0,0,3641,33,3608,3641,1798,1843,3532,42,077,006302
42,006303,0000002574759,00003039,1418,1418,0,1418,1366,52,3039,3039,0,0,3039,3016,2883,41,2,64,1,25,23,18,1,2,2,0,3039,41,2998,3039,1446,1593,2883,42,077,006303
42,006304,0000008554715,00003663,1420,1420,0,1420,1379,41,3663,3663,0,0,3663,3640,3341,11,8,275,0,5,23,23,0,0,0,0,3663,29,3634,3663,1786,1877,3341,42,077,006304
42,006305,0000007754676,00005540,2075,2075,0,2075,2023,52,5540,5540,0,0,5540,5491,5204,25,8,217,0,37,49,39,10,0,0,0,5540,87,5453,5540,2674,2866,5204,42,077,006305
42,006306,0000018324593,00008493,3241,3241,0,3241,3121,120,8493,8493,0,0,8493,8439,8004,71,4,324,0,36,54,54,0,0,0,0,8493,161,8332,8493,4183,4310,8004,42,077,006306
42,006400,0000046619438,00007234,2805,2805,0,2805,2728,77,7234,7234,0,0,7234,7195,7074,17,6,80,0,18,39,38,1,0,0,0,7234,76,7158,7234,3660,3574,7074,42,077,006400
42,006500,0000003781161,00005608,2635,2635,0,2635,2529,106,5608,5608,0,0,5608,5562,5383,44,6,49,2,78,46,45,1,0,0,0,5608,113,5495,5608,2665,2943,5383,42,077,006500
42,006600,0000003455321,00005360,2322,2322,0,2322,2242,80,5360,5360,0,0,5360,5335,5163,29,1,123,1,18,25,24,1,0,0,0,5360,52,5308,5360,2574,2786,5163,42,077,006600
42,006701,0000007839932,00004671,1904,1904,0,1904,1861,43,4671,4671,0,0,4671,4649,4453,98,1,41,4,52,22,21,1,0,0,0,4671,132,4539,4671,2289,2382,4453,42,077,006701
42,006702,0000013046726,00002908,1133,1133,0,1133,1075,58,2908,2908,0,0,2908,2865,2735,68,4,23,0,35,43,42,1,0,0,0,2908,89,2819,2908,1520,1388,2735,42,077,006702
42,006703,0000007653542,00005919,2244,2244,0,2244,2202,42,5919,5919,0,0,5919,5894,5691,38,0,136,1,28,25,25,0,0,0,0,5919,68,5851,5919,2799,3120,5691,42,077,006703
42,006800,0000001826474,00004614,2029,2029,0,2029,1911,118,4614,4614,0,0,4614,4511,4007,176,9,42,0,277,103,94,9,0,0,0,4614,495,4119,4614,2107,2507,4007,42,077,006800
42,006902,0000002472089,00002582,1050,1050,0,1050,983,67,2582,2582,0,0,2582,2556,2479,18,2,44,1,12,26,22,4,0,0,0,2582,46,2536,2582,1254,1328,2479,42,077,006902
42,006903,0000032720394,00004968,1601,1601,0,1601,1531,70,4968,4968,0,0,4968,4935,4821,41,3,50,1,19,33,32,1,0,0,0,4968,68,4900,4968,2463,2505,4821,42,077,006903
42,006904,0000031112768,00006971,2516,2516,0,2516,2439,77,6971,6971,0,0,6971,6933,6773,42,4,85,0,29,38,35,3,0,0,0,6971,60,6911,6971,3499,3472,6773,42,077,006904
42,007000,0000050896095,00003617,1308,1308,0,1308,1277,31,3617,3617,0,0,3617,3587,3548,6,9,20,0,4,30,25,5,0,0,0,3617,25,3592,3617,1828,1789,3548,42,077,007000
42,009100,0000004215475,00003242,1474,1474,0,1474,1435,39,3242,3242,0,0,3242,3227,3100,26,2,72,0,27,15,15,0,0,0,0,3242,98,3144,3242,1357,1885,3100,42,077,009100
42,009200,0000001875358,00003700,1855,1855,0,1855,1798,57,3700,3700,0,0,3700,3661,3428,81,2,116,1,33,39,33,5,0,0,1,3700,92,3608,3700,1767,1933,3428,42,077,009200
42,009300,0000001801517,00003213,1385,1385,0,1385,1346,39,3213,3213,0,0,3213,3173,3029,56,4,36,0,48,40,39,1,0,0,0,3213,130,3083,3213,1487,1726,3029,42,077,009300
42,009400,0000002010982,00003929,1630,1630,0,1630,1545,85,3929,3929,0,0,3929,3819,3323,146,5,43,0,302,110,101,8,0,1,0,3929,758,3171,3929,1727,2202,3323,42,077,009400
42,009500,0000001454635,00004945,2198,2198,0,2198,2064,134,4945,4945,0,0,4945,4838,4387,168,9,53,1,220,107,102,3,2,0,0,4945,606,4339,4945,2526,2419,4387,42,077,009500
42,200100,0000001756213,00003097,1300,1300,0,1300,1109,191,3097,3097,0,0,3097,3056,2862,138,3,33,1,19,41,40,1,0,0,0,3097,54,3043,3097,1414,1683,2862,42,079,200100
42,200200,0000001072229,00003638,1708,1708,0,1708,1506,202,3638,3638,0,0,3638,3581,3390,136,1,41,0,13,57,46,6,0,5,0,3638,42,3596,3638,1752,1886,3390,42,079,200200
42,200300,0000001002586,00001935,831,831,0,831,773,58,1935,1935,0,0,1935,1917,1827,68,1,15,3,3,18,18,0,0,0,0,1935,2,1933,1935,936,999,1827,42,079,200300
42,200400,0000000824822,00002725,1254,1254,0,1254,1131,123,2725,2725,0,0,2725,2697,2538,115,5,31,0,8,28,27,1,0,0,0,2725,24,2701,2725,1297,1428,2538,42,079,200400
42,200500,0000001015702,00002882,1656,1656,0,1656,1292,364,2882,2882,0,0,2882,2849,2526,221,8,53,1,40,33,32,1,0,0,0,2882,86,2796,2882,1486,1396,2526,42,079,200500
42,200600,0000000615427,00002199,1023,1023,0,1023,899,124,2199,2199,0,0,2199,2174,2097,57,4,4,0,12,25,25,0,0,0,0,2199,24,2175,2199,1068,1131,2097,42,079,200600
42,200700,0000000996351,00003645,1760,1760,0,1760,1578,182,3645,3645,0,0,3645,3584,3426,128,2,14,1,13,61,52,9,0,0,0,3645,30,3615,3645,1700,1945,3426,42,079,200700
42,200800,0000000936290,00003618,1712,1712,0,1712,1531,181,3618,3618,0,0,3618,3545,3125,340,6,53,2,19,73,63,10,0,0,0,3618,80,3538,3618,1591,2027,3125,42,079,200800
42,200900,0000000870359,00003232,1728,1728,0,1728,1557,171,3232,3232,0,0,3232,3203,2900,236,4,45,2,16,29,25,4,0,0,0,3232,65,3167,3232,1502,1730,2900,42,079,200900
42,201000,0000000894708,00002415,1333,1333,0,1333,1172,161,2415,2415,0,0,2415,2366,2079,261,5,8,0,13,49,47,2,0,0,0,2415,44,2371,2415,1063,1352,2079,42,079,201000
42,201100,0000000358888,00001249,600,600,0,600,514,86,1249,1249,0,0,1249,1243,1166,47,3,5,0,22,6,6,0,0,0,0,1249,49,1200,1249,619,630,1166,42,079,201100
42,201200,0000000840416,00002749,784,784,0,784,675,109,2749,2749,0,0,2749,2730,2439,248,0,4,2,37,19,17,1,0,1,0,2749,66,2683,2749,1713,1036,2439,42,079,201200
42,201300,0000001251707,00002032,997,997,0,997,893,104,2032,2032,0,0,2032,2024,1963,45,1,12,0,3,8,8,0,0,0,0,2032,30,2002,2032,965,1067,1963,42,079,201300
42,201400,0000000877081,00002299,1112,1112,0,1112,1006,106,2299,2299,0,0,2299,2271,2174,67,4,16,1,9,28,27,1,0,0,0,2299,64,2235,2299,1118,1181,2174,42,079,201400
42,201500,0000001846321,00002399,1081,1081,0,1081,1007,74,2399,2399,0,0,2399,2384,2310,72,0,1,1,0,15,14,1,0,0,0,2399,10,2389,2399,1123,1276,2310,42,079,201500
42,201600,0000002579548,00003009,1415,1415,0,1415,1318,97,3009,3009,0,0,3009,3002,2979,14,1,7,0,1,7,7,0,0,0,0,3009,13,2996,3009,1452,1557,2979,42,079,201600
42,210100,0000037198700,00003450,1437,1437,0,1437,1340,97,3450,3450,0,0,3450,3436,3421,10,0,3,0,2,14,14,0,0,0,0,3450,12,3438,3450,1702,1748,3421,42,079,210100
42,210200,0000003932146,00002719,1354,1354,0,1354,1228,126,2719,2719,0,0,2719,2712,2698,12,0,2,0,0,7,7,0,0,0,0,2719,3,2716,2719,1279,1440,2698,42,079,210200
42,210300,0000002317635,00002851,1267,1267,0,1267,1177,90,2851,2851,0,0,2851,2847,2830,4,0,4,6,3,4,4,0,0,0,0,2851,3,2848,2851,1375,1476,2830,42,079,210300
42,210400,0000002300950,00001541,659,659,0,659,615,44,1541,1541,0,0,1541,1536,1531,2,0,0,1,2,5,5,0,0,0,0,1541,2,1539,1541,760,781,1531,42,079,210400
42,210500,0000014271642,00004634,2151,2151,0,2151,1984,167,4634,4634,0,0,4634,4618,4581,12,5,16,0,4,16,16,0,0,0,0,4634,14,4620,4634,2172,2462,4581,42,079,210500
42,210600,0000000716168,00001267,693,693,0,693,617,76,1267,1267,0,0,1267,1264,1256,2,0,4,0,2,3,3,0,0,0,0,1267,10,1257,1267,592,675,1256,42,079,210600
42,210700,0000001737489,00001862,799,799,0,799,738,61,1862,1862,0,0,1862,1853,1826,9,0,9,1,8,9,9,0,0,0,0,1862,15,1847,1862,840,1022,1826,42,079,210700
42,210800,0000001109128,00003327,1641,1641,0,1641,1476,165,3327,3327,0,0,3327,3321,3283,22,3,9,0,4,6,6,0,0,0,0,3327,11,3316,3327,1521,1806,3283,42,079,210800
42,210900,0000000575023,00001648,769,769,0,769,699,70,1648,1648,0,0,1648,1638,1608,22,4,3,1,0,10,4,3,3,0,0,1648,19,1629,1648,759,889,1608,42,079,210900
42,211000,0000002119074,00005072,2381,2381,0,2381,2243,138,5072,5072,0,0,5072,5054,5040,5,2,2,0,5,18,16,2,0,0,0,5072,12,5060,5072,2292,2780,5040,42,079,211000
42,211101,0000012064310,00005955,2641,2641,0,2641,2482,159,5955,5955,0,0,5955,5924,5877,29,8,8,0,2,31,29,2,0,0,0,5955,34,5921,5955,2718,3237,5877,42,079,211101
42,211102,0000033370148,00002557,1038,1038,0,1038,943,95,2557,2557,0,0,2557,2556,2539,2,1,2,4,8,1,1,0,0,0,0,2557,9,2548,2557,1285,1272,2539,42,079,211102
42,211201,0000005929686,00002557,1094,1094,0,1094,1031,63,2557,2557,0,0,2557,2542,2505,12,2,20,0,3,15,15,0,0,0,0,2557,17,2540,2557,1211,1346,2505,42,079,211201
42,211202,0000048508531,00008179,3125,3125,0,3125,2917,208,8179,8179,0,0,8179,8145,8052,17,5,59,1,11,34,30,4,0,0,0,8179,46,8133,8179,3686,4493,8052,42,079,211202
42,211203,0000032934003,00001601,679,679,0,679,629,50,1601,1601,0,0,1601,1596,1594,1,0,0,0,1,5,5,0,0,0,0,1601,14,1587,1601,810,791,1594,42,079,211203
42,211301,0000034386096,00004453,1004,1004,0,1004,952,52,4453,4453,0,0,4453,4421,3251,1098,5,40,1,26,32,32,0,0,0,0,4453,185,4268,4453,3154,1299,3251,42,079,211301
42,211302,0000056112706,00003206,1403,1403,0,1403,1226,177,3206,3206,0,0,3206,3194,3153,15,9,17,0,0,12,12,0,0,0,0,3206,5,3201,3206,1573,1633,3153,42,079,211302
42,211303,0000013848375,00002888,1735,1735,0,1735,1185,550,2888,2888,0,0,2888,2867,2833,4,9,11,1,9,21,19,0,2,0,0,2888,22,2866,2888,1428,1460,2833,42,079,211303
42,211304,0000069887980,00002110,865,865,0,865,800,65,2110,2110,0,0,2110,2106,2093,0,4,3,3,3,4,4,0,0,0,0,2110,4,2106,2110,1070,1040,2093,42,079,211304
42,211400,0000035169587,00007145,2923,2923,0,2923,2745,178,7145,7145,0,0,7145,7117,7070,17,4,20,0,6,28,26,2,0,0,0,7145,27,7118,7145,3516,3629,7070,42,079,211400
42,211500,0000009405150,00002833,1240,1240,0,1240,1183,57,2833,2833,0,0,2833,2823,2814,5,0,2,1,1,10,10,0,0,0,0,2833,7,2826,2833,1363,1470,2814,42,079,211500
42,211600,0000003672430,00003221,1580,1580,0,1580,1487,93,3221,3221,0,0,3221,3215,3205,2,0,2,1,5,6,6,0,0,0,0,3221,9,3212,3221,1459,1762,3205,42,079,211600
42,211701,0000036622683,00005233,2084,2084,0,2084,1948,136,5233,5233,0,0,5233,5211,5184,13,3,7,1,3,22,22,0,0,0,0,5233,23,5210,5233,2373,2860,5184,42,079,211701
42,211702,0000003501391,00001502,632,632,0,632,612,20,1502,1502,0,0,1502,1495,1436,2,0,55,0,2,7,7,0,0,0,0,1502,9,1493,1502,707,795,1436,42,079,211702
42,211800,0000019974896,00002447,1023,1023,0,1023,900,123,2447,2447,0,0,2447,2434,2344,25,1,58,0,6,13,12,1,0,0,0,2447,27,2420,2447,1267,1180,2344,42,079,211800
42,211900,0000012661532,00006458,3036,3036,0,3036,2772,264,6458,6458,0,0,6458,6444,6419,12,1,9,0,3,14,13,1,0,0,0,6458,14,6444,6458,3091,3367,6419,42,079,211900
42,212000,0000001722950,00002001,948,948,0,948,884,64,2001,2001,0,0,2001,1998,1961,15,1,20,0,1,3,3,0,0,0,0,2001,15,1986,2001,920,1081,1961,42,079,212000
42,212100,0000003469432,00004579,2098,2098,0,2098,1989,109,4579,4579,0,0,4579,4560,4509,23,3,17,0,8,19,18,1,0,0,0,4579,24,4555,4579,2123,2456,4509,42,079,212100
42,212200,0000005596856,00005157,2356,2356,0,2356,2243,113,5157,5157,0,0,5157,5137,5117,5,3,8,0,4,20,20,0,0,0,0,5157,8,5149,5157,2434,2723,5117,42,079,212200
42,212300,0000001778344,00002952,1520,1520,0,1520,1410,110,2952,2952,0,0,2952,2938,2920,10,0,2,0,6,14,13,1,0,0,0,2952,13,2939,2952,1388,1564,2920,42,079,212300
42,212700,0000001895308,00005406,2670,2670,0,2670,2411,259,5406,5406,0,0,5406,5378,5217,52,7,83,0,19,28,28,0,0,0,0,5406,46,5360,5406,2511,2895,5217,42,079,212700
42,212800,0000001715871,00003598,1667,1667,0,1667,1578,89,3598,3598,0,0,3598,3580,3507,15,0,56,0,2,18,18,0,0,0,0,3598,8,3590,3598,1644,1954,3507,42,079,212800
42,212900,0000000533642,00001449,669,669,0,669,615,54,1449,1449,0,0,1449,1441,1409,10,2,18,0,2,8,8,0,0,0,0,1449,15,1434,1449,670,779,1409,42,079,212900
42,213000,0000000435829,00001507,738,738,0,738,693,45,1507,1507,0,0,1507,1500,1456,12,0,21,0,11,7,5,2,0,0,0,1507,22,1485,1507,688,819,1456,42,079,213000
42,213100,0000000972857,00001895,811,811,0,811,768,43,1895,1895,0,0,1895,1887,1828,17,1,34,1,6,8,8,0,0,0,0,1895,20,1875,1895,807,1088,1828,42,079,213100
42,213200,0000003049151,00004984,2587,2587,0,2587,2345,242,4984,4984,0,0,4984,4932,4756,128,15,15,0,18,52,47,0,5,0,0,4984,59,4925,4984,2196,2788,4756,42,079,213200
42,213300,0000003860180,00001782,787,787,0,787,747,40,1782,1782,0,0,1782,1781,1779,0,0,2,0,0,1,1,0,0,0,0,1782,10,1772,1782,861,921,1779,42,079,213300
42,213400,0000012329879,00004694,1939,1939,0,1939,1808,131,4694,4694,0,0,4694,4678,4644,13,2,13,0,6,16,16,0,0,0,0,4694,33,4661,4694,2279,2415,4644,42,079,213400
42,213600,0000000905086,00002407,1271,1271,0,1271,1064,207,2407,2407,0,0,2407,2398,2352,34,3,3,0,6,9,9,0,0,0,0,2407,16,2391,2407,1098,1309,2352,42,079,213600
42,213700,0000001020579,00002406,1130,1130,0,1130,993,137,2406,2406,0,0,2406,2395,2377,7,5,1,0,5,11,10,1,0,0,0,2406,17,2389,2406,1140,1266,2377,42,079,213700
42,213800,0000000919108,00001694,859,859,0,859,737,122,1694,1694,0,0,1694,1692,1676,8,2,3,0,3,2,2,0,0,0,0,1694,19,1675,1694,775,919,1676,42,079,213800
42,213900,0000040177463,00002097,899,899,0,899,821,78,2097,2097,0,0,2097,2087,2080,2,0,2,0,3,10,10,0,0,0,0,2097,7,2090,2097,1054,1043,2080,42,079,213900
42,214000,0000002916232,00001317,667,667,0,667,562,105,1317,1317,0,0,1317,1311,1303,1,1,1,0,5,6,6,0,0,0,0,1317,12,1305,1317,636,681,1303,42,079,214000
42,214100,0000000904909,00002622,1401,1401,0,1401,1230,171,2622,2622,0,0,2622,2609,2583,8,5,8,0,5,13,11,2,0,0,0,2622,14,2608,2622,1204,1418,2583,42,079,214100
42,214200,0000001157760,00002744,1434,1434,0,1434,1278,156,2744,2744,0,0,2744,2739,2714,10,2,7,0,6,5,4,1,0,0,0,2744,13,2731,2744,1264,1480,2714,42,079,214200
42,214300,0000002641974,00002067,962,962,0,962,859,103,2067,2067,0,0,2067,2063,2046,7,3,5,1,1,4,4,0,0,0,0,2067,6,2061,2067,969,1098,2046,42,079,214300
42,214400,0000001461624,00002205,1023,1023,0,1023,921,102,2205,2205,0,0,2205,2193,2182,4,0,7,0,0,12,11,1,0,0,0,2205,4,2201,2205,1043,1162,2182,42,079,214400
42,214500,0000002474318,00001753,856,856,0,856,788,68,1753,1753,0,0,1753,1748,1737,10,0,1,0,0,5,5,0,0,0,0,1753,8,1745,1753,820,933,1737,42,079,214500
42,214600,0000007165612,00004190,1952,1952,0,1952,1814,138,4190,4190,0,0,4190,4148,4092,38,1,13,0,4,42,42,0,0,0,0,4190,29,4161,4190,1928,2262,4092,42,079,214600
42,214700,0000004614458,00002938,1348,1348,0,1348,1259,89,2938,2938,0,0,2938,2925,2865,50,0,5,0,5,13,13,0,0,0,0,2938,23,2915,2938,1320,1618,2865,42,079,214700
42,214800,0000008665386,00001067,489,489,0,489,444,45,1067,1067,0,0,1067,1062,1054,6,1,0,0,1,5,5,0,0,0,0,1067,5,1062,1067,489,578,1054,42,079,214800
42,214900,0000025817673,00001540,693,693,0,693,646,47,1540,1540,0,0,1540,1531,1520,6,0,1,0,4,9,9,0,0,0,0,1540,4,1536,1540,762,778,1520,42,079,214900
42,215000,0000004646757,00001647,744,744,0,744,674,70,1647,1647,0,0,1647,1639,1634,2,0,2,0,1,8,6,2,0,0,0,1647,8,1639,1647,781,866,1634,42,079,215000
42,215100,0000002390491,00002866,1386,1386,0,1386,1245,141,2866,2866,0,0,2866,2844,2822,11,1,7,0,3,22,22,0,0,0,0,2866,12,2854,2866,1337,1529,2822,42,079,215100
42,215200,0000007664253,00003235,1572,1572,0,1572,1455,117,3235,3235,0,0,3235,3209,3006,76,7,117,0,3,26,25,1,0,0,0,3235,25,3210,3235,1554,1681,3006,42,079,215200
42,215300,0000233345863,00003983,1894,1894,0,1894,1550,344,3983,3983,0,0,3983,3972,3948,10,2,10,0,2,11,10,1,0,0,0,3983,24,3959,3983,2043,1940,3948,42,079,215300
42,215400,0000097992767,00002359,1229,1229,0,1229,961,268,2359,2359,0,0,2359,2351,2328,2,3,15,0,3,8,8,0,0,0,0,2359,20,2339,2359,1154,1205,2328,42,079,215400
42,215501,0000025226960,00003995,1502,1502,0,1502,1450,52,3995,3995,0,0,3995,3969,3842,33,2,84,0,8,26,26,0,0,0,0,3995,42,3953,3995,1923,2072,3842,42,079,215501
42,215502,0000033809913,00005593,2071,2071,0,2071,2005,66,5593,5593,0,0,5593,5561,5402,31,2,111,0,15,32,30,2,0,0,0,5593,66,5527,5593,2745,2848,5402,42,079,215502
42,215503,0000028696552,00002460,950,950,0,950,907,43,2460,2460,0,0,2460,2449,2378,12,0,50,0,9,11,10,1,0,0,0,2460,41,2419,2460,1189,1271,2378,42,079,215503
42,215504,0000091745217,00003892,1621,1621,0,1621,1453,168,3892,3892,0,0,3892,3876,3861,6,0,5,0,4,16,12,4,0,0,0,3892,18,3874,3892,1951,1941,3861,42,079,215504
42,215600,0000042363149,00005006,2166,2166,0,2166,1789,377,5006,5006,0,0,5006,4991,4514,429,6,15,0,27,15,15,0,0,0,0,5006,115,4891,5006,2808,2198,4514,42,079,215600
42,215701,0000055128350,00002568,988,988,0,988,952,36,2568,2568,0,0,2568,2553,2538,3,1,11,0,0,15,14,1,0,0,0,2568,1,2567,2568,1308,1260,2538,42,079,215701
42,215702,0000051541693,00002100,857,857,0,857,769,88,2100,2100,0,0,2100,2095,2085,3,2,5,0,0,5,5,0,0,0,0,2100,11,2089,2100,1066,1034,2085,42,079,215702
42,215800,0000111986122,00002742,1258,1258,0,1258,1041,217,2742,2742,0,0,2742,2724,2721,1,0,1,0,1,18,15,3,0,0,0,2742,13,2729,2742,1387,1355,2721,42,079,215800
42,215900,0000199881133,00003545,1587,1587,0,1587,1356,231,3545,3545,0,0,3545,3518,3481,13,14,6,1,3,27,21,6,0,0,0,3545,20,3525,3545,1776,1769,3481,42,079,215900
42,216000,0000000958546,00000959,478,478,0,478,415,63,959,959,0,0,959,951,949,0,0,0,0,2,8,8,0,0,0,0,959,1,958,959,449,510,949,42,079,216000
42,216100,0000075123215,00004269,1924,1924,0,1924,1743,181,4269,4269,0,0,4269,4255,4210,20,1,13,0,11,14,14,0,0,0,0,4269,28,4241,4269,2107,2162,4210,42,079,216100
42,216200,0000130791250,00005252,2345,2345,0,2345,2125,220,5252,5252,0,0,5252,5222,5160,22,8,15,4,13,30,30,0,0,0,0,5252,40,5212,5252,2587,2665,5160,42,079,216200
42,216400,0000063335594,00002132,965,965,0,965,832,133,2132,2132,0,0,2132,2130,2114,11,2,1,0,2,2,2,0,0,0,0,2132,10,2122,2132,1100,1032,2114,42,079,216400
42,216501,0000002763897,00001958,817,817,0,817,793,24,1958,1958,0,0,1958,1952,1907,1,0,44,0,0,6,6,0,0,0,0,1958,14,1944,1958,926,1032,1907,42,079,216501
42,216502,0000056759431,00003652,1302,1302,0,1302,1222,80,3652,3652,0,0,3652,3639,3580,10,4,37,0,8,13,13,0,0,0,0,3652,26,3626,3652,1878,1774,3580,42,079,216502
42,216600,0000086225457,00007166,2747,2747,0,2747,2523,224,7166,7166,0,0,7166,7124,6642,406,11,36,1,28,42,36,4,2,0,0,7166,128,7038,7166,3585,3581,6642,42,079,216600
42,216700,0000001804078,00003643,1847,1847,0,1847,1611,236,3643,3643,0,0,3643,3634,3590,4,2,26,0,12,9,9,0,0,0,0,3643,35,3608,3643,1693,1950,3590,42,079,216700
42,216800,0000116894596,00003467,1723,1723,0,1723,1329,394,3467,3467,0,0,3467,3456,3403,37,1,8,0,7,11,11,0,0,0,0,3467,26,3441,3467,1752,1715,3403,42,079,216800
42,216900,0000044651898,00004245,1814,1814,0,1814,1709,105,4245,4245,0,0,4245,4236,4218,4,0,8,0,6,9,6,3,0,0,0,4245,21,4224,4245,2105,2140,4218,42,079,216900
42,217001,0000063470512,00001895,933,933,0,933,845,88,1895,1895,0,0,1895,1888,1874,3,0,7,0,4,7,7,0,0,0,0,1895,10,1885,1895,931,964,1874,42,079,217001
42,217002,0000008229665,00002860,1255,1255,0,1255,1221,34,2860,2860,0,0,2860,2842,2788,8,5,13,0,28,18,16,2,0,0,0,2860,61,2799,2860,1232,1628,2788,42,079,217002
42,217100,0000001110735,00003151,1594,1594,0,1594,1434,160,3151,3151,0,0,3151,3137,3087,16,0,8,0,26,14,14,0,0,0,0,3151,52,3099,3151,1471,1680,3087,42,079,217100
42,217200,0000002205474,00002850,1538,1538,0,1538,1323,215,2850,2850,0,0,2850,2813,2661,30,4,21,0,97,37,37,0,0,0,0,2850,189,2661,2850,1309,1541,2661,42,079,217200
42,217300,0000005935730,00003652,1548,1548,0,1548,1449,99,3652,3652,0,0,3652,3639,3567,7,4,50,0,11,13,13,0,0,0,0,3652,35,3617,3652,1696,1956,3567,42,079,217300
42,217400,0000002949472,00001624,776,776,0,776,714,62,1624,1624,0,0,1624,1590,1451,37,2,12,0,88,34,34,0,0,0,0,1624,158,1466,1624,774,850,1451,42,079,217400
42,217500,0000000577193,00002242,1164,1164,0,1164,946,218,2242,2242,0,0,2242,2214,1944,29,6,13,2,220,28,26,1,0,1,0,2242,316,1926,2242,1103,1139,1944,42,079,217500
42,217600,0000000501663,00002460,1299,1299,0,1299,1114,185,2460,2460,0,0,2460,2436,2314,19,13,19,0,71,24,24,0,0,0,0,2460,121,2339,2460,1160,1300,2314,42,079,217600
42,217700,0000001431427,00004351,2164,2164,0,2164,1968,196,4351,4351,0,0,4351,4322,4174,41,9,15,1,82,29,29,0,0,0,0,4351,155,4196,4351,2027,2324,4174,42,079,217700
42,217800,0000000762822,00002999,1473,1473,0,1473,1333,140,2999,2999,0,0,2999,2971,2894,13,0,14,0,50,28,23,0,5,0,0,2999,106,2893,2999,1358,1641,2894,42,079,217800
42,217900,0000004018004,00003542,1834,1834,0,1834,1634,200,3542,3542,0,0,3542,3527,3461,20,2,8,0,36,15,15,0,0,0,0,3542,79,3463,3542,1705,1837,3461,42,079,217900
42,000100,0000002614164,00003254,1459,1459,0,1459,1400,59,3254,3254,0,0,3254,3208,3031,124,7,33,1,12,46,40,6,0,0,0,3254,36,3218,3254,1515,1739,3031,42,081,000100
42,000200,0000001775987,00002283,987,987,0,987,932,55,2283,2283,0,0,2283,2256,2073,146,5,25,0,7,27,21,6,0,0,0,2283,15,2268,2283,1110,1173,2073,42,081,000200
42,000300,0000002163308,00005973,2799,2799,0,2799,2485,314,5973,5973,0,0,5973,5863,5046,750,30,16,0,21,110,106,4,0,0,0,5973,81,5892,5973,2925,3048,5046,42,081,000300
42,000400,0000001286518,00005046,2590,2590,0,2590,2275,315,5046,5046,0,0,5046,4915,3213,1600,28,17,0,57,131,117,14,0,0,0,5046,76,4970,5046,2366,2680,3213,42,081,000400
42,000500,0000000899714,00003036,986,986,0,986,878,108,3036,3036,0,0,3036,3003,2736,217,1,31,2,16,33,29,4,0,0,0,3036,28,3008,3036,1443,1593,2736,42,081,000500
42,000600,0000001908405,00003058,1490,1490,0,1490,1259,231,3058,3058,0,0,3058,3010,2643,328,17,11,0,11,48,41,4,3,0,0,3058,34,3024,3058,1674,1384,2643,42,081,000600
42,000800,0000002523827,00002140,611,611,0,611,563,48,2140,2140,0,0,2140,2118,1814,287,2,1,0,14,22,22,0,0,0,0,2140,26,2114,2140,1430,710,1814,42,081,000800
42,000900,0000005654544,00002617,1121,1121,0,1121,1046,75,2617,2617,0,0,2617,2563,2431,104,11,13,1,3,54,54,0,0,0,0,2617,7,2610,2617,1192,1425,2431,42,081,000900
42,001000,0000004183353,00003299,1481,1481,0,1481,1381,100,3299,3299,0,0,3299,3238,2840,354,10,28,0,6,61,60,1,0,0,0,3299,37,3262,3299,1520,1779,2840,42,081,001000
42,010100,0000679173789,00002467,1509,1509,0,1509,946,563,2467,2467,0,0,2467,2461,2434,13,12,0,1,1,6,6,0,0,0,0,2467,9,2458,2467,1239,1228,2434,42,081,010100
42,010200,0000625227921,00001161,1552,1552,0,1552,508,1044,1161,1161,0,0,1161,1153,1150,2,0,0,0,1,8,8,0,0,0,0,1161,4,1157,1161,608,553,1150,42,081,010200
42,010300,0000140800128,00003568,1413,1413,0,1413,1302,111,3568,3568,0,0,3568,3552,3537,3,3,9,0,0,16,16,0,0,0,0,3568,6,3562,3568,1798,1770,3537,42,081,010300
42,010400,0000180611678,00005581,2368,2368,0,2368,2147,221,5581,5581,0,0,5581,5539,5497,20,4,18,0,0,42,42,0,0,0,0,5581,17,5564,5581,2802,2779,5497,42,081,010400
42,010500,0000450836141,00006076,2662,2662,0,2662,2266,396,6076,6076,0,0,6076,6055,6015,12,12,11,0,5,21,18,3,0,0,0,6076,19,6057,6076,3044,3032,6015,42,081,010500
42,010600,0000294750761,00004392,1951,1951,0,1951,1674,277,4392,4392,0,0,4392,4382,4367,6,5,4,0,0,10,10,0,0,0,0,4392,0,4392,4392,2256,2136,4367,42,081,010600
42,010700,0000082673885,00005962,2572,2572,0,2572,2413,159,5962,5962,0,0,5962,5925,5885,10,14,8,0,8,37,36,1,0,0,0,5962,26,5936,5962,2933,3029,5885,42,081,010700
42,010800,0000094821839,00007209,3123,3123,0,3123,2920,203,7209,7209,0,0,7209,7164,7096,8,16,31,0,13,45,41,3,0,1,0,7209,40,7169,7209,3444,3765,7096,42,081,010800
42,010900,0000030096896,00002659,1100,1100,0,1100,1020,80,2659,2659,0,0,2659,2640,2605,16,8,10,0,1,19,16,3,0,0,0,2659,14,2645,2659,1294,1365,2605,42,081,010900
42,011000,0000010475759,00004777,2169,2169,0,2169,2067,102,4777,4777,0,0,4777,4757,4730,5,3,16,0,3,20,20,0,0,0,0,4777,20,4757,4777,2270,2507,4730,42,081,011000
42,011100,0000008714189,00005641,2648,2648,0,2648,2534,114,5641,5641,0,0,5641,5577,5248,242,5,48,1,33,64,58,6,0,0,0,5641,71,5570,5641,2478,3163,5248,42,081,011100
42,011200,0000045703761,00005235,2039,2039,0,2039,1967,72,5235,5235,0,0,5235,5187,5064,45,9,66,0,3,48,48,0,0,0,0,5235,22,5213,5235,2408,2827,5064,42,081,011200
42,011300,0000058534182,00007905,3379,3379,0,3379,3226,153,7905,7905,0,0,7905,7855,7719,64,13,47,0,12,50,45,5,0,0,0,7905,17,7888,7905,3932,3973,7719,42,081,011300
42,011400,0000083264509,00001710,765,765,0,765,694,71,1710,1710,0,0,1710,1703,1696,4,3,0,0,0,7,7,0,0,0,0,1710,6,1704,1710,833,877,1696,42,081,011400
42,011600,0000006309903,00007692,3442,3442,0,3442,3275,167,7692,7692,0,0,7692,7656,7594,30,9,19,2,2,36,35,1,0,0,0,7692,37,7655,7692,3744,3948,7594,42,081,011600
42,011700,0000221915427,00007749,2453,2453,0,2453,2251,202,7749,7749,0,0,7749,7720,6837,774,19,23,0,67,29,29,0,0,0,0,7749,120,7629,7749,3826,3923,6837,42,081,011700
42,011800,0000138361082,00003439,1229,1229,0,1229,1161,68,3439,3439,0,0,3439,3419,3400,1,3,5,0,10,20,19,1,0,0,0,3439,22,3417,3439,1770,1669,3400,42,081,011800
42,011900,0000022973938,00006115,2566,2566,0,2566,2413,153,6115,6115,0,0,6115,6098,6036,24,9,19,4,6,17,17,0,0,0,0,6115,9,6106,6115,2828,3287,6036,42,081,011900
42,420100,0000094513190,00003712,1635,1635,0,1635,1519,116,3712,3712,0,0,3712,3698,3654,3,15,23,0,3,14,14,0,0,0,0,3712,13,3699,3712,1802,1910,3654,42,083,420100
42,420200,0000002880666,00003355,1748,1748,0,1748,1538,210,3355,3355,0,0,3355,3337,3294,12,12,6,1,12,18,16,2,0,0,0,3355,34,3321,3355,1596,1759,3294,42,083,420200
42,420300,0000001514729,00002758,1246,1246,0,1246,1120,126,2758,2758,0,0,2758,2739,2694,12,8,12,2,11,19,15,4,0,0,0,2758,26,2732,2758,1257,1501,2694,42,083,420300
42,420400,0000004539284,00003062,1377,1377,0,1377,1264,113,3062,3062,0,0,3062,3041,2980,21,8,30,0,2,21,21,0,0,0,0,3062,27,3035,3062,1451,1611,2980,42,083,420400
42,420500,0000121183572,00003325,1384,1384,0,1384,1291,93,3325,3325,0,0,3325,3316,3288,8,10,6,0,4,9,9,0,0,0,0,3325,12,3313,3325,1638,1687,3288,42,083,420500
42,420600,0000362517603,00006016,2737,2737,0,2737,2384,353,6016,6016,0,0,6016,5985,5948,7,23,5,0,2,31,31,0,0,0,0,6016,9,6007,6016,2955,3061,5948,42,083,420600
42,420700,0000319092326,00004787,2246,2246,0,2246,1887,359,4787,4787,0,0,4787,4758,4721,4,15,3,1,14,29,29,0,0,0,0,4787,17,4770,4787,2384,2403,4721,42,083,420700
42,420800,0000399053727,00004152,2086,2086,0,2086,1573,513,4152,4152,0,0,4152,4128,4100,11,4,4,6,3,24,23,1,0,0,0,4152,28,4124,4152,2044,2108,4100,42,083,420800
42,420900,0000458306095,00002504,1817,1817,0,1817,1058,759,2504,2504,0,0,2504,2496,2485,1,3,3,0,4,8,6,2,0,0,0,2504,14,2490,2504,1269,1235,2485,42,083,420900
42,421000,0000367236625,00005745,1835,1835,0,1835,1614,221,5745,5745,0,0,5745,5666,4687,774,46,40,0,119,79,74,4,0,1,0,5745,266,5479,5745,3474,2271,4687,42,083,421000
42,421100,0000299494113,00003955,2298,2298,0,2298,1726,572,3955,3955,0,0,3955,3932,3911,2,3,5,0,11,23,19,4,0,0,0,3955,28,3927,3955,1871,2084,3911,42,083,421100
42,421200,0000111913968,00002565,1235,1235,0,1235,1050,185,2565,2565,0,0,2565,2561,2550,5,2,2,1,1,4,4,0,0,0,0,2565,11,2554,2565,1272,1293,2550,42,083,421200
42,030100,0000001235868,00002524,1136,1136,0,1136,1008,128,2524,2524,0,0,2524,2474,2311,138,7,13,0,5,50,45,5,0,0,0,2524,24,2500,2524,1269,1255,2311,42,085,030100
42,030200,0000002261663,00000751,602,602,0,602,537,65,751,751,0,0,751,731,561,165,3,1,0,1,20,13,7,0,0,0,751,2,749,751,269,482,561,42,085,030200
42,030300,0000001887245,00004267,1858,1858,0,1858,1699,159,4267,4267,0,0,4267,4183,3956,203,6,10,0,8,84,79,3,2,0,0,4267,34,4233,4267,2042,2225,3956,42,085,030300
42,030400,0000002124109,00003027,1221,1221,0,1221,1163,58,3027,3027,0,0,3027,3000,2956,37,2,4,1,0,27,27,0,0,0,0,3027,25,3002,3027,1393,1634,2956,42,085,030400
42,030500,0000001239696,00002680,1256,1256,0,1256,1174,82,2680,2680,0,0,2680,2628,2258,354,5,2,2,7,52,46,6,0,0,0,2680,22,2658,2680,1260,1420,2258,42,085,030500
42,030600,0000000989673,00003079,1315,1315,0,1315,1210,105,3079,3079,0,0,3079,2973,2072,874,6,4,1,16,106,96,10,0,0,0,3079,37,3042,3079,1423,1656,2072,42,085,030600
42,030700,0000002551060,00001310,589,589,0,589,502,87,1310,1310,0,0,1310,1265,320,940,1,0,0,4,45,33,2,10,0,0,1310,6,1304,1310,602,708,320,42,085,030700
42,030800,0000000900145,00001656,727,727,0,727,622,105,1656,1656,0,0,1656,1599,428,1158,1,10,0,2,57,50,7,0,0,0,1656,15,1641,1656,722,934,428,42,085,030800
42,030900,0000002678501,00003102,1445,1445,0,1445,1389,56,3102,3102,0,0,3102,3060,2309,731,5,2,1,12,42,40,2,0,0,0,3102,19,3083,3102,1378,1724,2309,42,085,030900
42,031000,0000002285059,00000748,379,379,0,379,349,30,748,748,0,0,748,735,643,90,0,1,0,1,13,13,0,0,0,0,748,8,740,748,344,404,643,42,085,031000
42,031100,0000009690007,00001871,774,774,0,774,744,30,1871,1871,0,0,1871,1846,1602,236,1,1,0,6,25,23,2,0,0,0,1871,8,1863,1871,837,1034,1602,42,085,031100
42,031200,0000030130575,00005147,2157,2157,0,2157,2085,72,5147,5147,0,0,5147,5127,5013,63,2,40,0,9,20,19,1,0,0,0,5147,27,5120,5147,2457,2690,5013,42,085,031200
42,031300,0000022816370,00002563,1089,1089,0,1089,1048,41,2563,2563,0,0,2563,2551,2508,12,2,25,0,4,12,12,0,0,0,0,2563,21,2542,2563,1266,1297,2508,42,085,031300
42,031400,0000008965402,00005411,2582,2582,0,2582,2456,126,5411,5411,0,0,5411,5364,5211,74,2,61,0,16,47,41,6,0,0,0,5411,39,5372,5411,2452,2959,5211,42,085,031400
42,031500,0000004644876,00001147,493,493,0,493,467,26,1147,1147,0,0,1147,1113,995,112,0,3,1,2,34,29,5,0,0,0,1147,12,1135,1147,538,609,995,42,085,031500
42,031600,0000001762691,00001955,915,915,0,915,854,61,1955,1955,0,0,1955,1930,1833,84,4,6,0,3,25,23,2,0,0,0,1955,19,1936,1955,896,1059,1833,42,085,031600
42,031700,0000001829744,00002545,1101,1101,0,1101,1058,43,2545,2545,0,0,2545,2540,2496,20,2,12,0,10,5,5,0,0,0,0,2545,22,2523,2545,1218,1327,2496,42,085,031700
42,031800,0000244732173,00005092,2093,2093,0,2093,1937,156,5092,5092,0,0,5092,5069,5038,12,7,6,3,3,23,21,2,0,0,0,5092,15,5077,5092,2562,2530,5038,42,085,031800
42,031900,0000068473475,00004913,2023,2023,0,2023,1953,70,4913,4913,0,0,4913,4890,4841,14,9,22,0,4,23,23,0,0,0,0,4913,22,4891,4913,2368,2545,4841,42,085,031900
42,032000,0000154661336,00005354,2222,2222,0,2222,2035,187,5354,5354,0,0,5354,5321,5298,10,4,8,0,1,33,33,0,0,0,0,5354,14,5340,5354,2613,2741,5298,42,085,032000
42,032100,0000002970111,00003379,1372,1372,0,1372,1224,148,3379,3379,0,0,3379,3345,3203,95,4,37,1,5,34,33,1,0,0,0,3379,23,3356,3379,1640,1739,3203,42,085,032100
42,032200,0000002066409,00003001,1351,1351,0,1351,1240,111,3001,3001,0,0,3001,2989,2943,18,4,15,1,8,12,12,0,0,0,0,3001,8,2993,3001,1375,1626,2943,42,085,032200
42,032300,0000057939000,00003490,1401,1401,0,1401,1358,43,3490,3490,0,0,3490,3478,3453,13,0,8,0,4,12,10,2,0,0,0,3490,12,3478,3490,1705,1785,3453,42,085,032300
42,032400,0000127896872,00006593,2746,2746,0,2746,2577,169,6593,6593,0,0,6593,6560,6505,26,7,9,0,13,33,32,1,0,0,0,6593,33,6560,6593,3275,3318,6505,42,085,032400
42,032501,0000253553888,00006205,2539,2539,0,2539,2352,187,6205,6205,0,0,6205,6172,6148,12,2,7,0,3,33,33,0,0,0,0,6205,16,6189,6205,3053,3152,6148,42,085,032501
42,032502,0000111478876,00002257,928,928,0,928,852,76,2257,2257,0,0,2257,2248,2241,0,2,1,2,2,9,7,2,0,0,0,2257,14,2243,2257,1119,1138,2241,42,085,032502
42,032601,0000168166537,00006404,2519,2519,0,2519,2360,159,6404,6404,0,0,6404,6364,6289,32,12,20,1,10,40,40,0,0,0,0,6404,48,6356,6404,3142,3262,6289,42,085,032601
42,032602,0000057923764,00004696,1650,1650,0,1650,1562,88,4696,4696,0,0,4696,4669,4255,393,7,6,2,6,27,27,0,0,0,0,4696,112,4584,4696,2824,1872,4255,42,085,032602
42,032701,0000079825167,00004966,2091,2091,0,2091,2009,82,4966,4966,0,0,4966,4944,4844,74,3,13,0,10,22,21,1,0,0,0,4966,20,4946,4966,2408,2558,4844,42,085,032701
42,032702,0000053758291,00002561,952,952,0,952,909,43,2561,2561,0,0,2561,2552,2503,22,8,5,1,13,9,8,1,0,0,0,2561,20,2541,2561,1278,1283,2503,42,085,032702
42,032800,0000109538568,00005138,1862,1862,0,1862,1771,91,5138,5138,0,0,5138,5099,4825,231,2,34,3,4,39,36,3,0,0,0,5138,46,5092,5138,2764,2374,4825,42,085,032800
42,032900,0000003341691,00003183,1424,1424,0,1424,1333,91,3183,3183,0,0,3183,3160,3083,31,1,38,3,4,23,23,0,0,0,0,3183,16,3167,3183,1474,1709,3083,42,085,032900
42,033000,0000003659696,00004925,1370,1370,0,1370,1286,84,4925,4925,0,0,4925,4889,4796,32,4,50,0,7,36,35,1,0,0,0,4925,28,4897,4925,2381,2544,4796,42,085,033000
42,033100,0000142016762,00004353,1677,1677,0,1677,1589,88,4353,4353,0,0,4353,4325,4294,12,2,12,4,1,28,28,0,0,0,0,4353,16,4337,4353,2176,2177,4294,42,085,033100
42,960100,0000240283342,00003988,1956,1956,0,1956,1532,424,3988,3988,0,0,3988,3968,3940,3,0,17,0,8,20,20,0,0,0,0,3988,28,3960,3988,2012,1976,3940,42,087,960100
42,960200,0000085871274,00003852,1523,1523,0,1523,1403,120,3852,3852,0,0,3852,3840,3804,14,5,16,0,1,12,12,0,0,0,0,3852,8,3844,3852,1884,1968,3804,42,087,960200
42,960300,0000127838993,00005076,1793,1793,0,1793,1647,146,5076,5076,0,0,5076,5058,5008,36,2,4,0,8,18,18,0,0,0,0,5076,17,5059,5076,2380,2696,5008,42,087,960300
42,960400,0000128159671,00003030,1485,1485,0,1485,1181,304,3030,3030,0,0,3030,3019,2999,10,0,3,0,7,11,11,0,0,0,0,3030,16,3014,3030,1469,1561,2999,42,087,960400
42,960500,0000174639742,00003724,1749,1749,0,1749,1454,295,3724,3724,0,0,3724,3715,3705,6,0,3,0,1,9,9,0,0,0,0,3724,6,3718,3724,1834,1890,3705,42,087,960500
42,960600,0000104334707,00005397,2343,2343,0,2343,2194,149,5397,5397,0,0,5397,5376,5325,24,10,12,0,5,21,21,0,0,0,0,5397,24,5373,5397,2675,2722,5325,42,087,960600
42,960700,0000001178297,00002503,1262,1262,0,1262,1142,120,2503,2503,0,0,2503,2480,2426,25,6,12,1,10,23,22,1,0,0,0,2503,26,2477,2503,1116,1387,2426,42,087,960700
42,960800,0000002103198,00004027,2003,2003,0,2003,1742,261,4027,4027,0,0,4027,4000,3915,48,11,3,1,22,27,26,1,0,0,0,4027,65,3962,4027,1897,2130,3915,42,087,960800
42,960900,0000001936459,00002468,1250,1250,0,1250,1139,111,2468,2468,0,0,2468,2459,2433,13,1,11,0,1,9,9,0,0,0,0,2468,11,2457,2468,1076,1392,2433,42,087,960900
42,961000,0000002759397,00002144,983,983,0,983,919,64,2144,2144,0,0,2144,2137,2127,7,0,3,0,0,7,7,0,0,0,0,2144,7,2137,2144,1041,1103,2127,42,087,961000
42,961100,0000080551972,00007256,3161,3161,0,3161,2946,215,7256,7256,0,0,7256,7223,7136,22,1,46,0,18,33,32,1,0,0,0,7256,43,7213,7256,3480,3776,7136,42,087,961100
42,961200,0000117048858,00003021,1237,1237,0,1237,1114,123,3021,3021,0,0,3021,3012,2985,18,2,5,0,2,9,9,0,0,0,0,3021,12,3009,3021,1556,1465,2985,42,087,961200
42,300101,0000064833201,00002649,1270,1270,0,1270,925,345,2649,2649,0,0,2649,2613,2413,138,4,31,0,27,36,32,3,1,0,0,2649,103,2546,2649,1361,1288,2413,42,089,300101
42,300102,0000053868136,00005686,2562,2562,0,2562,1955,607,5686,5686,0,0,5686,5569,4885,421,6,45,0,212,117,114,3,0,0,0,5686,463,5223,5686,2834,2852,4885,42,089,300102
42,300103,0000083749608,00005809,3459,3459,0,3459,2018,1441,5809,5809,0,0,5809,5652,4913,460,19,106,1,153,157,144,11,2,0,0,5809,527,5282,5809,2987,2822,4913,42,089,300103
42,300200,0000200643008,00009293,4709,4709,0,4709,3603,1106,9293,9293,0,0,9293,9146,8424,471,21,78,1,151,147,142,5,0,0,0,9293,424,8869,9293,4540,4753,8424,42,089,300200
42,300301,0000124523691,00003583,3157,3157,0,3157,1416,1741,3583,3583,0,0,3583,3522,3240,168,11,22,7,74,61,60,1,0,0,0,3583,280,3303,3583,1788,1795,3240,42,089,300301
42,300302,0000097537586,00011622,6219,6219,0,6219,3685,2534,11622,11622,0,0,11622,11069,7643,2216,32,132,4,1042,553,531,22,0,0,0,11622,2047,9575,11622,5726,5896,7643,42,089,300302
42,300303,0000130599795,00006152,6199,6199,0,6199,2420,3779,6152,6152,0,0,6152,6061,5681,245,23,37,1,74,91,91,0,0,0,0,6152,312,5840,6152,3048,3104,5681,42,089,300303
42,300304,0000100062397,00004983,2967,2967,0,2967,1661,1306,4983,4983,0,0,4983,4841,4310,352,12,47,1,119,142,142,0,0,0,0,4983,472,4511,4983,2528,2455,4310,42,089,300304
42,300401,0000050352534,00003943,2047,2047,0,2047,1517,530,3943,3943,0,0,3943,3889,3710,87,3,33,4,52,54,48,6,0,0,0,3943,160,3783,3943,1976,1967,3710,42,089,300401
42,300402,0000038258584,00005664,2203,2203,0,2203,1986,217,5664,5664,0,0,5664,5536,4956,307,11,95,3,164,128,114,10,4,0,0,5664,388,5276,5664,2779,2885,4956,42,089,300402
42,300403,0000076119069,00005979,2744,2744,0,2744,2128,616,5979,5979,0,0,5979,5898,5485,201,18,72,7,115,81,71,10,0,0,0,5979,276,5703,5979,2936,3043,5485,42,089,300403
42,300500,0000060036786,00005672,3028,3028,0,3028,2084,944,5672,5672,0,0,5672,5548,4979,319,25,54,1,170,124,116,8,0,0,0,5672,419,5253,5672,2832,2840,4979,42,089,300500
42,300600,0000004182113,00004330,1779,1779,0,1779,1691,88,4330,4330,0,0,4330,4193,3769,249,8,70,1,96,137,125,12,0,0,0,4330,282,4048,4330,2097,2233,3769,42,089,300600
42,300700,0000003250550,00005558,1552,1552,0,1552,1454,98,5558,5558,0,0,5558,5461,4912,369,14,84,0,82,97,92,5,0,0,0,5558,268,5290,5558,2475,3083,4912,42,089,300700
42,300800,0000004594050,00005756,2630,2630,0,2630,2422,208,5756,5756,0,0,5756,5607,4985,371,12,109,0,130,149,134,14,1,0,0,5756,400,5356,5756,2675,3081,4985,42,089,300800
42,300900,0000013679930,00005132,2131,2131,0,2131,2055,76,5132,5132,0,0,5132,5064,4648,225,10,101,0,80,68,67,1,0,0,0,5132,231,4901,5132,2535,2597,4648,42,089,300900
42,301000,0000071602546,00009590,4166,4166,0,4166,3464,702,9590,9590,0,0,9590,9365,8108,765,17,140,2,333,225,202,20,3,0,0,9590,835,8755,9590,4718,4872,8108,42,089,301000
42,301100,0000099196277,00008235,3299,3299,0,3299,2947,352,8235,8235,0,0,8235,8166,7817,200,8,82,4,55,69,66,3,0,0,0,8235,229,8006,8235,4158,4077,7817,42,089,301100
42,301201,0000062282684,00010061,3905,3905,0,3905,3362,543,10061,10061,0,0,10061,9909,9174,486,15,104,2,128,152,141,11,0,0,0,10061,579,9482,10061,5081,4980,9174,42,089,301201
42,301202,0000034725022,00004357,1688,1688,0,1688,1544,144,4357,4357,0,0,4357,4305,4139,100,4,40,1,21,52,49,3,0,0,0,4357,124,4233,4357,2119,2238,4139,42,089,301202
42,301203,0000058573080,00005435,1974,1974,0,1974,1875,99,5435,5435,0,0,5435,5377,5251,59,4,21,0,42,58,52,6,0,0,0,5435,119,5316,5435,2754,2681,5251,42,089,301203
42,301301,0000080378417,00006533,2824,2824,0,2824,2301,523,6533,6533,0,0,6533,6487,6296,120,13,37,0,21,46,42,4,0,0,0,6533,220,6313,6533,3214,3319,6296,42,089,301301
42,301302,0000062963182,00002665,1069,1069,0,1069,941,128,2665,2665,0,0,2665,2643,2604,14,8,5,0,12,22,20,2,0,0,0,2665,37,2628,2665,1329,1336,2604,42,089,301302
42,200103,0000005288872,00003541,1206,1206,0,1206,1189,17,3541,3541,0,0,3541,3527,3366,15,6,132,0,8,14,12,0,0,2,0,3541,43,3498,3541,1734,1807,3366,42,091,200103
42,200104,0000005761331,00003913,1388,1388,0,1388,1376,12,3913,3913,0,0,3913,3887,3763,8,0,113,0,3,26,26,0,0,0,0,3913,26,3887,3913,1941,1972,3763,42,091,200104
42,200105,0000003974813,00002264,826,826,0,826,816,10,2264,2264,0,0,2264,2257,2121,16,0,113,0,7,7,6,1,0,0,0,2264,17,2247,2264,1108,1156,2121,42,091,200105
42,200106,0000003846031,00001563,789,789,0,789,731,58,1563,1563,0,0,1563,1554,1507,21,0,22,0,4,9,8,1,0,0,0,1563,17,1546,1563,681,882,1507,42,091,200106
42,200200,0000004952418,00001351,381,381,0,381,377,4,1351,1351,0,0,1351,1343,1308,14,1,17,0,3,8,6,2,0,0,0,1351,9,1342,1351,658,693,1308,42,091,200200
42,200301,0000004052155,00006077,2852,2852,0,2852,2780,72,6077,6077,0,0,6077,5995,5076,412,7,454,1,45,82,79,3,0,0,0,6077,153,5924,6077,2987,3090,5076,42,091,200301
42,200305,0000001233964,00002058,805,805,0,805,755,50,2058,2058,0,0,2058,2052,2020,9,5,1,0,17,6,5,1,0,0,0,2058,40,2018,2058,976,1082,2020,42,091,200305
42,200306,0000004293786,00003681,1445,1445,0,1445,1434,11,3681,3681,0,0,3681,3663,3554,44,1,37,2,25,18,15,3,0,0,0,3681,44,3637,3681,1828,1853,3554,42,091,200306
42,200307,0000001833174,00003332,1336,1336,0,1336,1296,40,3332,3332,0,0,3332,3289,2891,323,0,64,2,9,43,36,7,0,0,0,3332,57,3275,3332,1452,1880,2891,42,091,200307
42,200308,0000001716655,00004014,1768,1768,0,1768,1695,73,4014,4014,0,0,4014,3939,3492,229,4,171,1,42,75,68,7,0,0,0,4014,96,3918,4014,1941,2073,3492,42,091,200308
42,200309,0000000953625,00002697,985,985,0,985,965,20,2697,2697,0,0,2697,2681,2589,46,2,44,0,0,16,16,0,0,0,0,2697,17,2680,2697,1304,1393,2589,42,091,200309
42,200310,0000006534286,00003134,1212,1212,0,1212,1195,17,3134,3134,0,0,3134,3113,3051,27,5,22,0,8,21,16,4,1,0,0,3134,25,3109,3134,1472,1662,3051,42,091,200310
42,200401,0000001949595,00003456,1555,1555,0,1555,1507,48,3456,3456,0,0,3456,3436,3328,47,7,41,0,13,20,17,3,0,0,0,3456,42,3414,3456,1630,1826,3328,42,091,200401
42,200402,0000001720329,00003937,1566,1566,0,1566,1534,32,3937,3937,0,0,3937,3917,3750,97,3,37,0,30,20,17,3,0,0,0,3937,65,3872,3937,1919,2018,3750,42,091,200402
42,200501,0000007914115,00004053,1307,1307,0,1307,1298,9,4053,4053,0,0,4053,4032,3838,70,8,104,0,12,21,20,1,0,0,0,4053,36,4017,4053,2066,1987,3838,42,091,200501
42,200502,0000003381715,00005554,2457,2457,0,2457,2372,85,5554,5554,0,0,5554,5479,4814,314,20,267,0,64,75,70,5,0,0,0,5554,137,5417,5554,2864,2690,4814,42,091,200502
42,200505,0000018176452,00004799,1924,1924,0,1924,1874,50,4799,4799,0,0,4799,4757,4214,189,6,325,2,21,42,37,5,0,0,0,4799,97,4702,4799,2420,2379,4214,42,091,200505
42,200506,0000008129381,00004528,1430,1430,0,1430,1415,15,4528,4528,0,0,4528,4497,4167,111,7,191,1,20,31,30,1,0,0,0,4528,60,4468,4528,2241,2287,4167,42,091,200506
42,200507,0000007272154,00005298,2151,2151,0,2151,2123,28,5298,5298,0,0,5298,5246,4731,220,1,277,0,17,52,51,1,0,0,0,5298,57,5241,5298,2446,2852,4731,42,091,200507
42,200602,0000008502326,00005873,2302,2302,0,2302,2258,44,5873,5873,0,0,5873,5820,4947,245,8,603,0,17,53,50,3,0,0,0,5873,79,5794,5873,2811,3062,4947,42,091,200602
42,200603,0000004191805,00003353,1198,1198,0,1198,1183,15,3353,3353,0,0,3353,3320,3059,138,2,107,0,14,33,28,4,1,0,0,3353,64,3289,3353,1635,1718,3059,42,091,200603
42,200604,0000005466865,00008158,2796,2796,0,2796,2772,24,8158,8158,0,0,8158,8080,6969,266,5,810,3,27,78,70,5,3,0,0,8158,87,8071,8158,4024,4134,6969,42,091,200604
42,200605,0000009435986,00004641,1757,1757,0,1757,1713,44,4641,4641,0,0,4641,4589,3878,203,1,503,0,4,52,49,3,0,0,0,4641,49,4592,4641,2162,2479,3878,42,091,200605
42,200703,0000006496611,00004070,1518,1518,0,1518,1486,32,4070,4070,0,0,4070,4035,3659,82,9,254,0,31,35,32,3,0,0,0,4070,81,3989,4070,2005,2065,3659,42,091,200703
42,200704,0000004009096,00003320,1327,1327,0,1327,1266,61,3320,3320,0,0,3320,3290,3006,112,1,157,1,13,30,27,3,0,0,0,3320,52,3268,3320,1626,1694,3006,42,091,200704
42,200707,0000007917814,00003961,1866,1866,0,1866,1710,156,3961,3961,0,0,3961,3789,2907,293,4,494,5,86,172,147,22,0,3,0,3961,167,3794,3961,2072,1889,2907,42,091,200707
42,200708,0000007378043,00005361,1881,1881,0,1881,1840,41,5361,5361,0,0,5361,5285,4287,123,10,830,0,35,76,75,0,1,0,0,5361,100,5261,5361,2686,2675,4287,42,091,200708
42,200800,0000001644505,00002605,1139,1139,0,1139,1106,33,2605,2605,0,0,2605,2547,2141,46,8,314,1,37,58,54,4,0,0,0,2605,87,2518,2605,1273,1332,2141,42,091,200800
42,200901,0000002183007,00003990,1644,1644,0,1644,1563,81,3990,3990,0,0,3990,3892,3359,133,3,342,17,38,98,92,6,0,0,0,3990,116,3874,3990,1859,2131,3359,42,091,200901
42,200902,0000000356749,00001329,573,573,0,573,552,21,1329,1329,0,0,1329,1301,1168,65,0,57,1,10,28,28,0,0,0,0,1329,41,1288,1329,649,680,1168,42,091,200902
42,200903,0000002148882,00003934,1871,1871,0,1871,1792,79,3934,3934,0,0,3934,3879,3305,167,4,379,0,24,55,49,6,0,0,0,3934,138,3796,3934,1944,1990,3305,42,091,200903
42,200906,0000001226709,00002116,818,818,0,818,793,25,2116,2116,0,0,2116,2083,1626,92,4,351,0,10,33,33,0,0,0,0,2116,63,2053,2116,1016,1100,1626,42,091,200906
42,200907,0000000982319,00002656,1098,1098,0,1098,1069,29,2656,2656,0,0,2656,2625,2476,83,2,55,0,9,31,30,1,0,0,0,2656,45,2611,2656,1277,1379,2476,42,091,200907
42,200908,0000001037024,00002046,889,889,0,889,851,38,2046,2046,0,0,2046,2019,1791,94,2,98,7,27,27,27,0,0,0,0,2046,63,1983,2046,993,1053,1791,42,091,200908
42,201003,0000006958770,00004346,1830,1830,0,1830,1763,67,4346,4346,0,0,4346,4322,3715,222,6,354,0,25,24,22,2,0,0,0,4346,73,4273,4346,2093,2253,3715,42,091,201003
42,201004,0000003353157,00004429,1869,1869,0,1869,1807,62,4429,4429,0,0,4429,4367,3734,160,4,447,0,22,62,60,2,0,0,0,4429,97,4332,4429,2006,2423,3734,42,091,201004
42,201005,0000005465117,00003689,1206,1206,0,1206,1190,16,3689,3689,0,0,3689,3658,3291,108,1,252,0,6,31,31,0,0,0,0,3689,27,3662,3689,1825,1864,3291,42,091,201005
42,201006,0000005297705,00001779,591,591,0,591,581,10,1779,1779,0,0,1779,1762,1618,76,0,63,0,5,17,13,0,4,0,0,1779,10,1769,1779,902,877,1618,42,091,201006
42,201100,0000001479939,00003342,1330,1330,0,1330,1299,31,3342,3342,0,0,3342,3283,3018,161,2,70,6,26,59,55,3,0,1,0,3342,50,3292,3342,1666,1676,3018,42,091,201100
42,201201,0000013793645,00005428,2161,2161,0,2161,2057,104,5428,5428,0,0,5428,5385,4884,150,4,330,0,17,43,37,6,0,0,0,5428,63,5365,5428,2502,2926,4884,42,091,201201
42,201203,0000007739385,00002914,1271,1271,0,1271,1229,42,2914,2914,0,0,2914,2905,2775,65,1,61,1,2,9,9,0,0,0,0,2914,8,2906,2914,1256,1658,2775,42,091,201203
42,201204,0000002656001,00002080,928,928,0,928,891,37,2080,2080,0,0,2080,2030,1387,596,3,36,0,8,50,35,15,0,0,0,2080,38,2042,2080,928,1152,1387,42,091,201204
42,201301,0000001136024,00003357,1351,1351,0,1351,1311,40,3357,3357,0,0,3357,3326,2927,265,3,121,1,9,31,29,2,0,0,0,3357,36,3321,3357,1503,1854,2927,42,091,201301
42,201302,0000001052198,00003069,1254,1254,0,1254,1199,55,3069,3069,0,0,3069,3010,2425,508,13,38,3,23,59,58,1,0,0,0,3069,101,2968,3069,1477,1592,2425,42,091,201302
42,201404,0000008774125,00004984,1811,1811,0,1811,1744,67,4984,4984,0,0,4984,4965,4343,129,1,490,0,2,19,18,1,0,0,0,4984,35,4949,4984,2460,2524,4343,42,091,201404
42,201406,0000005979079,00004617,1590,1590,0,1590,1573,17,4617,4617,0,0,4617,4583,3988,358,10,215,0,12,34,32,0,2,0,0,4617,49,4568,4617,2292,2325,3988,42,091,201406
42,201407,0000002437758,00002414,857,857,0,857,842,15,2414,2414,0,0,2414,2396,1750,583,5,44,1,13,18,17,1,0,0,0,2414,27,2387,2414,1171,1243,1750,42,091,201407
42,201408,0000006092114,00004627,1485,1485,0,1485,1477,8,4627,4627,0,0,4627,4600,4027,93,1,475,0,4,27,23,4,0,0,0,4627,33,4594,4627,2237,2390,4027,42,091,201408
42,201409,0000006092249,00004282,1504,1504,0,1504,1482,22,4282,4282,0,0,4282,4260,3957,70,4,228,0,1,22,22,0,0,0,0,4282,45,4237,4282,2123,2159,3957,42,091,201409
42,201410,0000002429247,00002444,1034,1034,0,1034,1011,23,2444,2444,0,0,2444,2438,2260,68,0,101,0,9,6,6,0,0,0,0,2444,28,2416,2444,1159,1285,2260,42,091,201410
42,201411,0000002378725,00002510,1063,1063,0,1063,1045,18,2510,2510,0,0,2510,2481,2312,101,2,58,0,8,29,25,4,0,0,0,2510,16,2494,2510,1177,1333,2312,42,091,201411
42,201501,0000004539577,00003462,1528,1528,0,1528,1446,82,3462,3462,0,0,3462,3434,3171,45,1,214,1,2,28,23,5,0,0,0,3462,48,3414,3462,1497,1965,3171,42,091,201501
42,201502,0000003742333,00001843,719,719,0,719,705,14,1843,1843,0,0,1843,1831,1763,23,1,43,0,1,12,12,0,0,0,0,1843,19,1824,1843,872,971,1763,42,091,201502
42,201603,0000002401307,00004663,1757,1757,0,1757,1703,54,4663,4663,0,0,4663,4541,2520,1892,10,88,2,29,122,100,22,0,0,0,4663,102,4561,4663,2136,2527,2520,42,091,201603
42,201604,0000001036636,00003339,1184,1184,0,1184,1162,22,3339,3339,0,0,3339,3298,2278,914,4,73,2,27,41,41,0,0,0,0,3339,66,3273,3339,1644,1695,2278,42,091,201604
42,201605,0000001193035,00003086,1086,1086,0,1086,1072,14,3086,3086,0,0,3086,3036,2619,316,3,66,0,32,50,47,3,0,0,0,3086,64,3022,3086,1464,1622,2619,42,091,201605
42,201606,0000000897906,00002589,980,980,0,980,950,30,2589,2589,0,0,2589,2544,1623,822,5,57,11,26,45,41,4,0,0,0,2589,49,2540,2589,1219,1370,1623,42,091,201606
42,201607,0000001594034,00003600,1442,1442,0,1442,1417,25,3600,3600,0,0,3600,3549,3178,232,1,119,0,19,51,38,13,0,0,0,3600,66,3534,3600,1715,1885,3178,42,091,201607
42,201608,0000005004844,00004580,1794,1794,0,1794,1759,35,4580,4580,0,0,4580,4534,4198,159,2,158,3,14,46,45,1,0,0,0,4580,67,4513,4580,2200,2380,4198,42,091,201608
42,201703,0000002179738,00003127,1170,1170,0,1170,1150,20,3127,3127,0,0,3127,3107,2985,68,5,28,3,18,20,20,0,0,0,0,3127,39,3088,3127,1523,1604,2985,42,091,201703
42,201704,0000001374393,00003434,1286,1286,0,1286,1259,27,3434,3434,0,0,3434,3404,2877,470,1,38,0,18,30,28,2,0,0,0,3434,45,3389,3434,1666,1768,2877,42,091,201704
42,201705,0000001872188,00004538,1724,1724,0,1724,1689,35,4538,4538,0,0,4538,4491,4209,132,4,130,2,14,47,43,4,0,0,0,4538,69,4469,4538,2203,2335,4209,42,091,201705
42,201706,0000002524102,00004361,1793,1793,0,1793,1722,71,4361,4361,0,0,4361,4313,3716,338,6,218,4,31,48,40,3,5,0,0,4361,75,4286,4361,2126,2235,3716,42,091,201706
42,201800,0000002398480,00003127,1473,1473,0,1473,1412,61,3127,3127,0,0,3127,3102,2938,71,4,82,0,7,25,20,4,1,0,0,3127,26,3101,3127,1304,1823,2938,42,091,201800
42,201901,0000005049943,00004546,1830,1830,0,1830,1801,29,4546,4546,0,0,4546,4528,4326,26,2,158,0,16,18,16,2,0,0,0,4546,60,4486,4546,2204,2342,4326,42,091,201901
42,201902,0000004216854,00005808,2601,2601,0,2601,2443,158,5808,5808,0,0,5808,5753,4793,564,2,360,0,34,55,54,1,0,0,0,5808,88,5720,5808,2714,3094,4793,42,091,201902
42,202000,0000000898443,00002577,1091,1091,0,1091,1060,31,2577,2577,0,0,2577,2560,2525,1,1,25,0,8,17,17,0,0,0,0,2577,15,2562,2577,1234,1343,2525,42,091,202000
42,202100,0000001478587,00004478,2085,2085,0,2085,2035,50,4478,4478,0,0,4478,4438,4192,179,2,42,1,22,40,36,3,1,0,0,4478,58,4420,4478,1975,2503,4192,42,091,202100
42,202201,0000003227902,00004953,1794,1794,0,1794,1760,34,4953,4953,0,0,4953,4900,4234,315,3,318,1,29,53,49,4,0,0,0,4953,90,4863,4953,2334,2619,4234,42,091,202201
42,202202,0000002084114,00002953,998,998,0,998,983,15,2953,2953,0,0,2953,2875,1561,810,7,435,1,61,78,72,3,0,3,0,2953,118,2835,2953,1448,1505,1561,42,091,202202
42,202301,0000002747421,00004865,2186,2186,0,2186,2038,148,4865,4865,0,0,4865,4815,4254,250,3,262,2,44,50,40,7,3,0,0,4865,89,4776,4865,2315,2550,4254,42,091,202301
42,202302,0000001736854,00002317,1005,1005,0,1005,959,46,2317,2317,0,0,2317,2272,1734,458,2,72,0,6,45,43,2,0,0,0,2317,46,2271,2317,1062,1255,1734,42,091,202302
42,202401,0000000729586,00003472,1736,1736,0,1736,1675,61,3472,3472,0,0,3472,3368,200,2768,8,341,0,51,104,89,11,4,0,0,3472,83,3389,3472,1614,1858,200,42,091,202401
42,202402,0000002712465,00005105,1856,1856,0,1856,1794,62,5105,5105,0,0,5105,5007,2743,1602,9,591,1,61,98,85,10,3,0,0,5105,131,4974,5105,2438,2667,2743,42,091,202402
42,202500,0000005331589,00005012,2088,2088,0,2088,1967,121,5012,5012,0,0,5012,4943,2758,2005,8,145,15,12,69,61,7,1,0,0,5012,66,4946,5012,2097,2915,2758,42,091,202500
42,202602,0000001620337,00002675,937,937,0,937,926,11,2675,2675,0,0,2675,2661,2402,215,2,34,3,5,14,13,1,0,0,0,2675,19,2656,2675,1141,1534,2402,42,091,202602
42,202603,0000001507707,00003187,1369,1369,0,1369,1332,37,3187,3187,0,0,3187,3157,2735,306,4,103,0,9,30,26,4,0,0,0,3187,46,3141,3187,1485,1702,2735,42,091,202603
42,202604,0000001692677,00002336,928,928,0,928,912,16,2336,2336,0,0,2336,2314,1882,345,0,75,0,12,22,20,1,1,0,0,2336,44,2292,2336,1144,1192,1882,42,091,202604
42,203000,0000017124475,00002630,993,993,0,993,933,60,2630,2630,0,0,2630,2594,2393,72,0,124,0,5,36,28,8,0,0,0,2630,41,2589,2630,1308,1322,2393,42,091,203000
42,203103,0000006990314,00002951,1045,1045,0,1045,1017,28,2951,2951,0,0,2951,2948,2814,27,0,104,0,3,3,3,0,0,0,0,2951,24,2927,2951,1469,1482,2814,42,091,203103
42,203104,0000004245495,00004015,1437,1437,0,1437,1416,21,4015,4015,0,0,4015,3991,3843,68,2,75,0,3,24,24,0,0,0,0,4015,27,3988,4015,1879,2136,3843,42,091,203104
42,203105,0000007681511,00005456,2134,2134,0,2134,2086,48,5456,5456,0,0,5456,5435,5061,149,1,212,0,12,21,21,0,0,0,0,5456,57,5399,5456,2603,2853,5061,42,091,203105
42,203106,0000001786883,00001650,763,763,0,763,727,36,1650,1650,0,0,1650,1628,1471,53,1,103,0,0,22,22,0,0,0,0,1650,16,1634,1650,819,831,1471,42,091,203106
42,203203,0000005171778,00004205,1657,1657,0,1657,1509,148,4205,4205,0,0,4205,4164,3554,210,2,380,0,18,41,36,5,0,0,0,4205,73,4132,4205,2072,2133,3554,42,091,203203
42,203204,0000008296250,00005728,2345,2345,0,2345,2241,104,5728,5728,0,0,5728,5680,4902,187,8,577,0,6,48,44,4,0,0,0,5728,89,5639,5728,2704,3024,4902,42,091,203204
42,203205,0000005952050,00002319,828,828,0,828,807,21,2319,2319,0,0,2319,2282,1844,337,0,94,0,7,37,29,8,0,0,0,2319,20,2299,2319,1123,1196,1844,42,091,203205
42,203207,0000008340162,00003283,1100,1100,0,1100,1082,18,3283,3283,0,0,3283,3263,2977,70,2,206,0,8,20,20,0,0,0,0,3283,34,3249,3283,1619,1664,2977,42,091,203207
42,203208,0000005710362,00003027,1375,1375,0,1375,1321,54,3027,3027,0,0,3027,3008,2744,66,0,195,0,3,19,19,0,0,0,0,3027,31,2996,3027,1429,1598,2744,42,091,203208
42,203302,0000007650418,00006435,2295,2295,0,2295,2249,46,6435,6435,0,0,6435,6400,5865,337,5,172,0,21,35,34,1,0,0,0,6435,65,6370,6435,3116,3319,5865,42,091,203302
42,203303,0000003939632,00003536,1397,1397,0,1397,1361,36,3536,3536,0,0,3536,3495,3064,301,9,98,0,23,41,41,0,0,0,0,3536,49,3487,3536,1643,1893,3064,42,091,203303
42,203304,0000002299977,00003238,1613,1613,0,1613,1545,68,3238,3238,0,0,3238,3208,2801,162,3,235,0,7,30,28,2,0,0,0,3238,40,3198,3238,1528,1710,2801,42,091,203304
42,203401,0000003523701,00006356,2944,2944,0,2944,2840,104,6356,6356,0,0,6356,6264,5560,526,9,132,2,35,92,85,6,1,0,0,6356,124,6232,6356,3001,3355,5560,42,091,203401
42,203402,0000006701969,00005520,2380,2380,0,2380,2325,55,5520,5520,0,0,5520,5480,4947,269,2,228,6,28,40,39,1,0,0,0,5520,80,5440,5520,2689,2831,4947,42,091,203402
42,203403,0000003648657,00003025,1565,1565,0,1565,1449,116,3025,3025,0,0,3025,2998,2828,114,0,47,0,9,27,26,1,0,0,0,3025,32,2993,3025,1448,1577,2828,42,091,203403
42,203500,0000001748460,00005971,2642,2642,0,2642,2484,158,5971,5971,0,0,5971,5843,3427,2006,12,249,0,149,128,117,11,0,0,0,5971,365,5606,5971,2830,3141,3427,42,091,203500
42,203601,0000000444904,00002767,1200,1200,0,1200,1018,182,2767,2767,0,0,2767,2677,735,1736,4,44,2,156,90,80,10,0,0,0,2767,323,2444,2767,1347,1420,735,42,091,203601
42,203602,0000001103479,00003792,1497,1497,0,1497,1413,84,3792,3792,0,0,3792,3667,2537,984,3,62,1,80,125,119,5,1,0,0,3792,169,3623,3792,1702,2090,2537,42,091,203602
42,203700,0000004850533,00001532,513,513,0,513,445,68,1532,1532,0,0,1532,1507,1098,372,2,20,0,15,25,23,2,0,0,0,1532,67,1465,1532,860,672,1098,42,091,203700
42,203801,0000000836338,00003409,1409,1409,0,1409,1310,99,3409,3409,0,0,3409,3272,2523,551,2,103,0,93,137,123,14,0,0,0,3409,301,3108,3409,1660,1749,2523,42,091,203801
42,203803,0000000771820,00004977,2344,2344,0,2344,2020,324,4977,4977,0,0,4977,4813,2987,1309,7,196,2,312,164,152,12,0,0,0,4977,614,4363,4977,2490,2487,2987,42,091,203803
42,203804,0000000619356,00002950,1188,1188,0,1188,1046,142,2950,2950,0,0,2950,2862,1734,935,15,58,4,116,88,86,2,0,0,0,2950,316,2634,2950,1479,1471,1734,42,091,203804
42,203901,0000000440370,00003101,1318,1318,0,1318,1056,262,3101,3101,0,0,3101,2993,731,1861,14,41,0,346,108,101,7,0,0,0,3101,712,2389,3101,1514,1587,731,42,091,203901
42,203902,0000001471703,00002785,1426,1426,0,1426,1237,189,2785,2785,0,0,2785,2689,1220,1133,4,155,1,176,96,90,6,0,0,0,2785,415,2370,2785,1349,1436,1220,42,091,203902
42,204002,0000007471215,00003042,1363,1363,0,1363,1313,50,3042,3042,0,0,3042,2988,2649,187,3,127,2,20,54,51,3,0,0,0,3042,66,2976,3042,1493,1549,2649,42,091,204002
42,204004,0000002009889,00002868,1266,1266,0,1266,1206,60,2868,2868,0,0,2868,2856,2650,102,6,94,0,4,12,12,0,0,0,0,2868,31,2837,2868,1336,1532,2650,42,091,204004
42,204005,0000001043163,00000966,361,361,0,361,353,8,966,966,0,0,966,963,861,39,1,60,0,2,3,3,0,0,0,0,966,8,958,966,471,495,861,42,091,204005
42,204007,0000001608977,00002261,970,970,0,970,960,10,2261,2261,0,0,2261,2236,1860,125,2,242,0,7,25,25,0,0,0,0,2261,34,2227,2261,1127,1134,1860,42,091,204007
42,204008,0000003018873,00002859,1145,1145,0,1145,1127,18,2859,2859,0,0,2859,2831,2590,101,0,131,0,9,28,21,7,0,0,0,2859,34,2825,2859,1403,1456,2590,42,091,204008
42,204009,0000003968028,00001438,658,658,0,658,624,34,1438,1438,0,0,1438,1429,1270,67,1,86,0,5,9,9,0,0,0,0,1438,8,1430,1438,679,759,1270,42,091,204009
42,204010,0000002667650,00002611,940,940,0,940,929,11,2611,2611,0,0,2611,2599,2441,48,1,97,0,12,12,11,0,1,0,0,2611,20,2591,2611,1297,1314,2441,42,091,204010
42,204101,0000001279699,00004715,2103,2103,0,2103,2009,94,4715,4715,0,0,4715,4692,4542,92,1,43,0,14,23,21,2,0,0,0,4715,57,4658,4715,2320,2395,4542,42,091,204101
42,204102,0000001266213,00002874,1415,1415,0,1415,1320,95,2874,2874,0,0,2874,2827,2279,498,5,21,1,23,47,47,0,0,0,0,2874,45,2829,2874,1362,1512,2279,42,091,204102
42,204200,0000002201240,00001446,633,633,0,633,600,33,1446,1446,0,0,1446,1430,1358,41,1,26,1,3,16,16,0,0,0,0,1446,15,1431,1446,730,716,1358,42,091,204200
42,204300,0000002055446,00002454,1263,1263,0,1263,1180,83,2454,2454,0,0,2454,2435,2239,98,9,81,1,7,19,19,0,0,0,0,2454,46,2408,2454,1153,1301,2239,42,091,204300
42,204400,0000002428161,00003237,1244,1244,0,1244,1206,38,3237,3237,0,0,3237,3212,3021,42,2,138,0,9,25,25,0,0,0,0,3237,34,3203,3237,1537,1700,3021,42,091,204400
42,204500,0000002752567,00004880,1718,1718,0,1718,1665,53,4880,4880,0,0,4880,4821,4541,122,0,128,5,25,59,55,3,1,0,0,4880,68,4812,4880,2352,2528,4541,42,091,204500
42,204600,0000004819574,00004756,1618,1618,0,1618,1591,27,4756,4756,0,0,4756,4721,4510,51,3,137,0,20,35,35,0,0,0,0,4756,61,4695,4756,2208,2548,4510,42,091,204600
42,204701,0000003162271,00002260,1146,1146,0,1146,1111,35,2260,2260,0,0,2260,2246,2103,42,1,98,1,1,14,14,0,0,0,0,2260,20,2240,2260,1043,1217,2103,42,091,204701
42,204702,0000002724704,00003350,1320,1320,0,1320,1282,38,3350,3350,0,0,3350,3312,3115,56,2,126,0,13,38,31,7,0,0,0,3350,46,3304,3350,1647,1703,3115,42,091,204702
42,204800,0000015780528,00005399,2036,2036,0,2036,1952,84,5399,5399,0,0,5399,5358,5181,42,2,123,3,7,41,41,0,0,0,0,5399,51,5348,5399,2529,2870,5181,42,091,204800
42,204900,0000010281165,00005047,1785,1785,0,1785,1721,64,5047,5047,0,0,5047,5015,4773,121,2,106,0,13,32,30,2,0,0,0,5047,60,4987,5047,2230,2817,4773,42,091,204900
42,205000,0000001274788,00001764,834,834,0,834,780,54,1764,1764,0,0,1764,1737,1430,235,3,63,0,6,27,25,2,0,0,0,1764,39,1725,1764,802,962,1430,42,091,205000
42,205100,0000001890726,00003190,841,841,0,841,804,37,3190,3190,0,0,3190,3108,2560,232,2,261,14,39,82,79,3,0,0,0,3190,95,3095,3190,864,2326,2560,42,091,205100
42,205200,0000003260467,00002933,1347,1347,0,1347,1291,56,2933,2933,0,0,2933,2908,2814,23,0,61,0,10,25,25,0,0,0,0,2933,32,2901,2933,1347,1586,2814,42,091,205200
42,205300,0000000669475,00002856,871,871,0,871,832,39,2856,2856,0,0,2856,2815,1931,674,8,150,1,51,41,39,2,0,0,0,2856,98,2758,2856,1346,1510,1931,42,091,205300
42,205400,0000004793358,00006057,2767,2767,0,2767,2662,105,6057,6057,0,0,6057,5982,5630,102,7,209,4,30,75,68,3,4,0,0,6057,111,5946,6057,2846,3211,5630,42,091,205400
42,205501,0000000978425,00003732,1801,1801,0,1801,1744,57,3732,3732,0,0,3732,3647,2850,636,4,106,11,40,85,79,6,0,0,0,3732,99,3633,3732,1672,2060,2850,42,091,205501
42,205502,0000002130356,00003340,1294,1294,0,1294,1267,27,3340,3340,0,0,3340,3303,3157,35,0,99,1,11,37,27,6,4,0,0,3340,50,3290,3340,1576,1764,3157,42,091,205502
42,205503,0000002361391,00004595,1814,1814,0,1814,1780,34,4595,4595,0,0,4595,4557,4192,183,0,162,0,20,38,37,1,0,0,0,4595,46,4549,4595,2080,2515,4192,42,091,205503
42,205600,0000001279030,00004233,1981,1981,0,1981,1904,77,4233,4233,0,0,4233,4188,4031,50,5,96,0,6,45,38,7,0,0,0,4233,59,4174,4233,1946,2287,4031,42,091,205600
42,205700,0000001694774,00004371,2088,2088,0,2088,1983,105,4371,4371,0,0,4371,4281,3997,117,6,106,0,55,90,85,4,1,0,0,4371,168,4203,4371,2166,2205,3997,42,091,205700
42,205801,0000012480338,00002617,1743,1743,0,1743,1600,143,2617,2617,0,0,2617,2581,2062,105,0,376,2,36,36,35,1,0,0,0,2617,61,2556,2617,1295,1322,2062,42,091,205801
42,205805,0000002640727,00003132,1291,1291,0,1291,1267,24,3132,3132,0,0,3132,3069,2658,97,0,283,0,31,63,48,15,0,0,0,3132,54,3078,3132,1522,1610,2658,42,091,205805
42,205806,0000001909391,00001780,735,735,0,735,702,33,1780,1780,0,0,1780,1759,1627,55,1,73,0,3,21,21,0,0,0,0,1780,33,1747,1780,852,928,1627,42,091,205806
42,205807,0000001630407,00002013,1225,1225,0,1225,1074,151,2013,2013,0,0,2013,1981,1546,98,3,308,0,26,32,31,0,1,0,0,2013,48,1965,2013,1037,976,1546,42,091,205807
42,205808,0000004849249,00004671,1639,1639,0,1639,1618,21,4671,4671,0,0,4671,4620,4019,173,0,410,0,18,51,51,0,0,0,0,4671,93,4578,4671,2247,2424,4019,42,091,205808
42,205809,0000002283665,00002791,992,992,0,992,983,9,2791,2791,0,0,2791,2755,2450,108,8,171,2,16,36,34,2,0,0,0,2791,36,2755,2791,1357,1434,2450,42,091,205809
42,205903,0000004245903,00002470,946,946,0,946,924,22,2470,2470,0,0,2470,2439,2225,103,1,105,2,3,31,30,1,0,0,0,2470,31,2439,2470,1198,1272,2225,42,091,205903
42,205904,0000003734849,00002231,958,958,0,958,935,23,2231,2231,0,0,2231,2211,1985,159,1,61,0,5,20,20,0,0,0,0,2231,29,2202,2231,1092,1139,1985,42,091,205904
42,205905,0000003162361,00003220,1787,1787,0,1787,1679,108,3220,3220,0,0,3220,3180,2515,203,17,414,3,28,40,38,2,0,0,0,3220,62,3158,3220,1652,1568,2515,42,091,205905
42,205906,0000006731524,00001938,835,835,0,835,793,42,1938,1938,0,0,1938,1914,1680,144,3,70,5,12,24,24,0,0,0,0,1938,34,1904,1938,976,962,1680,42,091,205906
42,206004,0000005828957,00005867,1623,1623,0,1623,1566,57,5867,5867,0,0,5867,5819,4204,1224,7,250,14,120,48,48,0,0,0,0,5867,213,5654,5867,3496,2371,4204,42,091,206004
42,206005,0000004465963,00004652,1620,1620,0,1620,1581,39,4652,4652,0,0,4652,4620,4311,57,8,238,0,6,32,30,2,0,0,0,4652,60,4592,4652,2331,2321,4311,42,091,206005
42,206006,0000004650797,00001924,720,720,0,720,706,14,1924,1924,0,0,1924,1917,1834,28,2,48,0,5,7,7,0,0,0,0,1924,13,1911,1924,950,974,1834,42,091,206006
42,206007,0000010887112,00005311,2082,2082,0,2082,2002,80,5311,5311,0,0,5311,5288,4575,262,3,361,1,86,23,23,0,0,0,0,5311,128,5183,5311,2775,2536,4575,42,091,206007
42,206008,0000008644844,00004182,1463,1463,0,1463,1421,42,4182,4182,0,0,4182,4158,3950,51,4,138,0,15,24,22,1,0,1,0,4182,50,4132,4182,2065,2117,3950,42,091,206008
42,206009,0000005274620,00000454,182,182,0,182,170,12,454,454,0,0,454,452,440,2,0,10,0,0,2,2,0,0,0,0,454,6,448,454,218,236,440,42,091,206009
42,206102,0000017558680,00005105,2065,2065,0,2065,1981,84,5105,5105,0,0,5105,5076,4721,138,6,194,2,15,29,28,1,0,0,0,5105,85,5020,5105,2471,2634,4721,42,091,206102
42,206104,0000009179204,00002383,839,839,0,839,821,18,2383,2383,0,0,2383,2356,2208,73,0,58,0,17,27,26,1,0,0,0,2383,36,2347,2383,1175,1208,2208,42,091,206104
42,206105,0000013941534,00003564,992,992,0,992,965,27,3564,3564,0,0,3564,3537,3349,90,1,92,2,3,27,27,0,0,0,0,3564,47,3517,3564,1636,1928,3349,42,091,206105
42,206106,0000005537560,00004346,1649,1649,0,1649,1588,61,4346,4346,0,0,4346,4312,4121,94,8,83,0,6,34,30,4,0,0,0,4346,39,4307,4346,2045,2301,4121,42,091,206106
42,206201,0000001254647,00002584,1311,1311,0,1311,1243,68,2584,2584,0,0,2584,2569,2514,29,3,15,0,8,15,13,2,0,0,0,2584,20,2564,2584,1230,1354,2514,42,091,206201
42,206202,0000000781563,00001662,728,728,0,728,685,43,1662,1662,0,0,1662,1638,1561,54,7,12,0,4,24,20,4,0,0,0,1662,30,1632,1662,818,844,1561,42,091,206202
42,206300,0000004038863,00008032,1438,1438,0,1438,1408,30,8032,8032,0,0,8032,7967,4966,2505,8,171,1,316,65,63,2,0,0,0,8032,412,7620,8032,5671,2361,4966,42,091,206300
42,206400,0000005373914,00003210,1351,1351,0,1351,1292,59,3210,3210,0,0,3210,3157,3018,77,7,44,0,11,53,53,0,0,0,0,3210,38,3172,3210,1599,1611,3018,42,091,206400
42,206500,0000012518340,00007093,2556,2556,0,2556,2468,88,7093,7093,0,0,7093,7011,6596,223,8,135,5,44,82,76,6,0,0,0,7093,108,6985,7093,3517,3576,6596,42,091,206500
42,206600,0000001044390,00001693,662,662,0,662,626,36,1693,1693,0,0,1693,1673,1595,48,0,19,1,10,20,19,1,0,0,0,1693,36,1657,1693,794,899,1595,42,091,206600
42,206701,0000029184201,00006410,2474,2474,0,2474,2350,124,6410,6410,0,0,6410,6377,6220,61,18,59,0,19,33,27,6,0,0,0,6410,69,6341,6410,3109,3301,6220,42,091,206701
42,206702,0000006648159,00000106,3,3,0,3,3,0,106,106,0,0,106,106,19,80,0,0,0,7,0,0,0,0,0,0,106,9,97,106,103,3,19,42,091,206702
42,206801,0000030562756,00005345,1978,1978,0,1978,1905,73,5345,5345,0,0,5345,5297,4888,127,2,268,0,12,48,47,1,0,0,0,5345,48,5297,5345,2592,2753,4888,42,091,206801
42,206802,0000011447866,00002444,1048,1048,0,1048,991,57,2444,2444,0,0,2444,2427,2289,54,0,77,0,7,17,15,2,0,0,0,2444,20,2424,2444,1189,1255,2289,42,091,206802
42,206901,0000004090475,00004379,1739,1739,0,1739,1694,45,4379,4379,0,0,4379,4291,3580,179,4,489,3,36,88,82,6,0,0,0,4379,98,4281,4379,2107,2272,3580,42,091,206901
42,206904,0000007930883,00005325,2338,2338,0,2338,2255,83,5325,5325,0,0,5325,5248,4749,214,6,242,0,37,77,74,3,0,0,0,5325,93,5232,5325,2403,2922,4749,42,091,206904
42,206905,0000008373049,00004777,1702,1702,0,1702,1684,18,4777,4777,0,0,4777,4717,4282,165,4,258,1,7,60,58,2,0,0,0,4777,64,4713,4777,2336,2441,4282,42,091,206905
42,206906,0000004707465,00003116,1256,1256,0,1256,1239,17,3116,3116,0,0,3116,3100,2927,53,1,108,0,11,16,16,0,0,0,0,3116,36,3080,3116,1517,1599,2927,42,091,206906
42,207001,0000027412326,00005946,2083,2083,0,2083,2029,54,5946,5946,0,0,5946,5878,5516,199,3,143,0,17,68,63,4,1,0,0,5946,53,5893,5946,2910,3036,5516,42,091,207001
42,207003,0000005612508,00002564,893,893,0,893,869,24,2564,2564,0,0,2564,2552,2425,51,2,68,0,6,12,12,0,0,0,0,2564,33,2531,2564,1297,1267,2425,42,091,207003
42,207004,0000004326152,00004383,1555,1555,0,1555,1534,21,4383,4383,0,0,4383,4348,4103,129,2,91,6,17,35,35,0,0,0,0,4383,97,4286,4383,2119,2264,4103,42,091,207004
42,207101,0000023703487,00005011,1780,1780,0,1780,1748,32,5011,5011,0,0,5011,4986,4910,30,4,35,0,7,25,25,0,0,0,0,5011,41,4970,5011,2429,2582,4910,42,091,207101
42,207103,0000007071341,00003782,1278,1278,0,1278,1264,14,3782,3782,0,0,3782,3757,3561,50,2,119,0,25,25,25,0,0,0,0,3782,45,3737,3782,1852,1930,3561,42,091,207103
42,207104,0000005050037,00002730,1178,1178,0,1178,1139,39,2730,2730,0,0,2730,2726,2657,19,3,43,1,3,4,4,0,0,0,0,2730,17,2713,2730,1196,1534,2657,42,091,207104
42,207201,0000000939771,00002527,1004,1004,0,1004,963,41,2527,2527,0,0,2527,2505,2374,34,2,76,2,17,22,21,1,0,0,0,2527,81,2446,2527,1254,1273,2374,42,091,207201
42,207202,0000001957735,00004203,1716,1716,0,1716,1672,44,4203,4203,0,0,4203,4141,3797,33,11,192,0,108,62,59,3,0,0,0,4203,208,3995,4203,2069,2134,3797,42,091,207202
42,207300,0000001251738,00002469,962,962,0,962,942,20,2469,2469,0,0,2469,2421,2236,27,0,124,1,33,48,42,6,0,0,0,2469,97,2372,2469,1236,1233,2236,42,091,207300
42,207400,0000024697496,00002363,821,821,0,821,807,14,2363,2363,0,0,2363,2340,2300,16,2,18,0,4,23,23,0,0,0,0,2363,26,2337,2363,1189,1174,2300,42,091,207400
42,207500,0000023326287,00003024,1074,1074,0,1074,1053,21,3024,3024,0,0,3024,3002,2935,15,8,26,1,17,22,21,1,0,0,0,3024,25,2999,3024,1500,1524,2935,42,091,207500
42,207600,0000033304817,00003688,1457,1457,0,1457,1405,52,3688,3688,0,0,3688,3655,3597,28,5,5,0,20,33,30,3,0,0,0,3688,40,3648,3688,1841,1847,3597,42,091,207600
42,207800,0000052369664,00004885,1764,1764,0,1764,1737,27,4885,4885,0,0,4885,4862,4790,34,7,15,0,16,23,22,1,0,0,0,4885,39,4846,4885,2471,2414,4790,42,091,207800
42,207900,0000001867226,00002196,944,944,0,944,899,45,2196,2196,0,0,2196,2166,2148,7,1,2,1,7,30,19,4,7,0,0,2196,34,2162,2196,1047,1149,2148,42,091,207900
42,208000,0000001983261,00002732,1078,1078,0,1078,1009,69,2732,2732,0,0,2732,2712,2660,22,2,13,0,15,20,17,3,0,0,0,2732,44,2688,2732,1297,1435,2660,42,091,208000
42,208100,0000001344185,00003103,1173,1173,0,1173,1124,49,3103,3103,0,0,3103,3079,3003,28,4,16,0,28,24,23,1,0,0,0,3103,82,3021,3103,1511,1592,3003,42,091,208100
42,208201,0000024908576,00002373,815,815,0,815,803,12,2373,2373,0,0,2373,2365,2347,7,0,4,1,6,8,7,1,0,0,0,2373,11,2362,2373,1212,1161,2347,42,091,208201
42,208203,0000007830149,00003748,1508,1508,0,1508,1461,47,3748,3748,0,0,3748,3720,3632,33,6,43,1,5,28,27,1,0,0,0,3748,16,3732,3748,1818,1930,3632,42,091,208203
42,208204,0000006998228,00002983,969,969,0,969,947,22,2983,2983,0,0,2983,2973,2922,30,1,18,0,2,10,10,0,0,0,0,2983,16,2967,2983,1472,1511,2922,42,091,208204
42,208301,0000033270559,00002387,917,917,0,917,873,44,2387,2387,0,0,2387,2376,2355,4,1,13,0,3,11,10,1,0,0,0,2387,18,2369,2387,1203,1184,2355,42,091,208301
42,208302,0000022651310,00004982,1698,1698,0,1698,1659,39,4982,4982,0,0,4982,4960,4890,19,4,45,1,1,22,18,4,0,0,0,4982,38,4944,4982,2485,2497,4890,42,091,208302
42,208400,0000025816778,00003141,1088,1088,0,1088,1045,43,3141,3141,0,0,3141,3112,3047,45,6,9,0,5,29,28,1,0,0,0,3141,16,3125,3141,1528,1613,3047,42,091,208400
42,208500,0000020711171,00004795,1806,1806,0,1806,1730,76,4795,4795,0,0,4795,4742,4580,89,11,39,0,23,53,52,1,0,0,0,4795,71,4724,4795,2355,2440,4580,42,091,208500
42,208601,0000028794668,00004081,1555,1555,0,1555,1479,76,4081,4081,0,0,4081,4053,3932,52,9,44,0,16,28,28,0,0,0,0,4081,39,4042,4081,2038,2043,3932,42,091,208601
42,208603,0000017190498,00004942,1998,1998,0,1998,1873,125,4942,4942,0,0,4942,4893,4669,143,13,49,0,19,49,45,1,1,2,0,4942,65,4877,4942,2442,2500,4669,42,091,208603
42,208604,0000012475710,00004511,1889,1889,0,1889,1791,98,4511,4511,0,0,4511,4471,4270,90,4,82,0,25,40,37,3,0,0,0,4511,75,4436,4511,2240,2271,4270,42,091,208604
42,208702,0000007098097,00003266,1237,1237,0,1237,1203,34,3266,3266,0,0,3266,3247,3185,29,1,27,1,4,19,18,1,0,0,0,3266,20,3246,3266,1646,1620,3185,42,091,208702
42,208703,0000006836496,00003717,1401,1401,0,1401,1366,35,3717,3717,0,0,3717,3689,3532,120,4,29,0,4,28,26,2,0,0,0,3717,47,3670,3717,1831,1886,3532,42,091,208703
42,208704,0000006513694,00004230,1489,1489,0,1489,1446,43,4230,4230,0,0,4230,4135,3287,772,7,45,3,21,95,88,7,0,0,0,4230,70,4160,4230,1956,2274,3287,42,091,208704
42,208801,0000000617315,00001130,575,575,0,575,536,39,1130,1130,0,0,1130,1105,984,90,3,6,0,22,25,25,0,0,0,0,1130,59,1071,1130,544,586,984,42,091,208801
42,208802,0000002078484,00002989,1389,1389,0,1389,1289,100,2989,2989,0,0,2989,2952,2747,140,7,23,1,34,37,37,0,0,0,0,2989,66,2923,2989,1451,1538,2747,42,091,208802
42,208901,0000001740900,00003448,1554,1554,0,1554,1466,88,3448,3448,0,0,3448,3370,3050,234,8,18,6,54,78,77,1,0,0,0,3448,79,3369,3448,1653,1795,3050,42,091,208901
42,208903,0000002139257,00002872,1268,1268,0,1268,1140,128,2872,2872,0,0,2872,2772,1837,839,11,17,1,67,100,89,11,0,0,0,2872,203,2669,2872,1344,1528,1837,42,091,208903
42,208904,0000000509080,00003020,1608,1608,0,1608,1350,258,3020,3020,0,0,3020,2888,1984,724,7,34,3,136,132,126,6,0,0,0,3020,278,2742,3020,1491,1529,1984,42,091,208904
42,208905,0000001181922,00002800,1280,1280,0,1280,1240,40,2800,2800,0,0,2800,2762,2666,66,0,13,6,11,38,36,2,0,0,0,2800,39,2761,2800,1317,1483,2666,42,091,208905
42,208906,0000001215636,00004015,1629,1629,0,1629,1491,138,4015,4015,0,0,4015,3887,3013,778,6,16,2,72,128,121,5,2,0,0,4015,208,3807,4015,1898,2117,3013,42,091,208906
42,209000,0000003025390,00001585,670,670,0,670,634,36,1585,1585,0,0,1585,1522,1062,420,8,15,0,17,63,59,4,0,0,0,1585,58,1527,1585,688,897,1062,42,091,209000
42,209100,0000013075993,00004102,1459,1459,0,1459,1417,42,4102,4102,0,0,4102,4066,3905,103,10,37,0,11,36,34,2,0,0,0,4102,42,4060,4102,2046,2056,3905,42,091,209100
42,209201,0000005096312,00001597,652,652,0,652,621,31,1597,1597,0,0,1597,1572,1440,109,1,13,0,9,25,25,0,0,0,0,1597,30,1567,1597,777,820,1440,42,091,209201
42,209202,0000000995363,00002218,954,954,0,954,903,51,2218,2218,0,0,2218,2180,1966,166,6,19,1,22,38,38,0,0,0,0,2218,53,2165,2218,1060,1158,1966,42,091,209202
42,210100,0000002736320,00003839,1537,1537,0,1537,1502,35,3839,3839,0,0,3839,3808,3635,84,8,71,0,10,31,29,2,0,0,0,3839,49,3790,3839,1841,1998,3635,42,091,210100
42,210200,0000002584251,00002756,1064,1064,0,1064,1056,8,2756,2756,0,0,2756,2745,2483,190,4,59,0,9,11,10,0,1,0,0,2756,28,2728,2756,1346,1410,2483,42,091,210200
42,210300,0000004985280,00003807,1528,1528,0,1528,1478,50,3807,3807,0,0,3807,3788,3538,172,1,59,1,17,19,16,1,0,0,2,3807,37,3770,3807,1779,2028,3538,42,091,210300
42,210400,0000003885813,00004827,1805,1805,0,1805,1779,26,4827,4827,0,0,4827,4786,4077,594,1,101,0,13,41,37,4,0,0,0,4827,48,4779,4827,2044,2783,4077,42,091,210400
42,210500,0000003402563,00004304,1697,1697,0,1697,1656,41,4304,4304,0,0,4304,4258,3561,583,11,86,0,17,46,43,3,0,0,0,4304,41,4263,4304,1962,2342,3561,42,091,210500
42,950100,0000143782880,00003808,1446,1446,0,1446,1351,95,3808,3808,0,0,3808,3785,3739,31,2,7,0,6,23,23,0,0,0,0,3808,10,3798,3808,1904,1904,3739,42,093,950100
42,950200,0000021342696,00004263,1542,1542,0,1542,1466,76,4263,4263,0,0,4263,4231,4006,82,1,116,0,26,32,26,5,1,0,0,4263,73,4190,4263,1871,2392,4006,42,093,950200
42,950300,0000004108354,00004897,2523,2523,0,2523,2277,246,4897,4897,0,0,4897,4859,4704,38,6,88,0,23,38,35,3,0,0,0,4897,56,4841,4897,2235,2662,4704,42,093,950300
42,950400,0000169409371,00005268,2116,2116,0,2116,1991,125,5268,5268,0,0,5268,5253,5179,34,3,23,0,14,15,14,1,0,0,0,5268,28,5240,5268,2651,2617,5179,42,093,950400
42,010100,0000001710353,00003659,1572,1572,0,1572,1515,57,3659,3659,0,0,3659,3600,3195,153,11,129,0,112,59,58,1,0,0,0,3659,301,3358,3659,1755,1904,3195,42,095,010100
42,010200,0000007321205,00003929,1485,1485,0,1485,1445,40,3929,3929,0,0,3929,3878,3693,29,1,139,1,15,51,49,2,0,0,0,3929,44,3885,3929,1809,2120,3693,42,095,010200
42,010300,0000001799074,00003297,1532,1532,0,1532,1460,72,3297,3297,0,0,3297,3253,3109,48,3,34,0,59,44,42,0,0,2,0,3297,137,3160,3297,1561,1736,3109,42,095,010300
42,010400,0000002617604,00004894,2161,2161,0,2161,2105,56,4894,4894,0,0,4894,4839,4499,168,5,98,2,67,55,54,1,0,0,0,4894,237,4657,4894,2311,2583,4499,42,095,010400
42,010500,0000001985843,00004428,1778,1778,0,1778,1725,53,4428,4428,0,0,4428,4188,2092,378,21,29,0,1668,240,231,8,1,0,0,4428,2631,1797,4428,1956,2472,2092,42,095,010500
42,010600,0000002760485,00006672,3069,3069,0,3069,2940,129,6672,6672,0,0,6672,6538,6056,104,9,76,2,291,134,129,5,0,0,0,6672,636,6036,6672,3165,3507,6056,42,095,010600
42,010700,0000001124064,00004824,1814,1814,0,1814,1700,114,4824,4824,0,0,4824,4715,4222,130,15,85,0,263,109,102,7,0,0,0,4824,445,4379,4824,2229,2595,4222,42,095,010700
42,010800,0000000777691,00002632,1577,1577,0,1577,1493,84,2632,2632,0,0,2632,2578,2351,82,7,39,0,99,54,54,0,0,0,0,2632,215,2417,2632,1112,1520,2351,42,095,010800
42,010900,0000000564880,00003334,1396,1396,0,1396,1263,133,3334,3334,0,0,3334,3172,2169,301,16,23,1,662,162,160,2,0,0,0,3334,1263,2071,3334,1583,1751,2169,42,095,010900
42,011000,0000000672466,00005633,1326,1326,0,1326,1183,143,5633,5633,0,0,5633,5473,4458,225,18,322,1,449,160,149,9,2,0,0,5633,901,4732,5633,3233,2400,4458,42,095,011000
42,011100,0000000946392,00000427,84,84,0,84,79,5,427,427,0,0,427,420,340,23,1,46,1,9,7,6,1,0,0,0,427,31,396,427,242,185,340,42,095,011100
42,011200,0000001238587,00005395,2118,2118,0,2118,1926,192,5395,5395,0,0,5395,5104,3163,342,38,113,14,1434,291,281,9,1,0,0,5395,2766,2629,5395,2702,2693,3163,42,095,011200
42,011300,0000014994470,00003176,1177,1177,0,1177,1094,83,3176,3176,0,0,3176,3026,1768,136,16,132,0,974,150,141,9,0,0,0,3176,1711,1465,3176,1569,1607,1768,42,095,011300
42,014100,0000003136540,00005348,1614,1614,0,1614,1529,85,5348,5348,0,0,5348,5246,4967,147,5,90,6,31,102,92,7,2,1,0,5348,137,5211,5348,2637,2711,4967,42,095,014100
42,014200,0000001303031,00005714,2407,2407,0,2407,2199,208,5714,5714,0,0,5714,5500,4546,577,9,118,0,250,214,204,8,2,0,0,5714,544,5170,5714,2695,3019,4546,42,095,014200
42,014300,0000001114725,00004324,1610,1610,0,1610,1389,221,4324,4324,0,0,4324,4153,3149,727,15,60,12,190,171,163,8,0,0,0,4324,751,3573,4324,2378,1946,3149,42,095,014300
42,014400,0000000894930,00002420,1464,1464,0,1464,1231,233,2420,2420,0,0,2420,2368,1935,276,10,46,5,96,52,51,1,0,0,0,2420,271,2149,2420,1171,1249,1935,42,095,014400
42,014500,0000001479526,00002950,1240,1240,0,1240,1140,100,2950,2950,0,0,2950,2847,1979,651,11,77,3,126,103,91,11,1,0,0,2950,351,2599,2950,1393,1557,1979,42,095,014500
42,014600,0000002200708,00003053,1245,1245,0,1245,1148,97,3053,3053,0,0,3053,2945,2058,628,6,20,2,231,108,101,7,0,0,0,3053,410,2643,3053,1471,1582,2058,42,095,014600
42,014700,0000000897916,00002454,965,965,0,965,908,57,2454,2454,0,0,2454,2382,1976,332,7,26,0,41,72,70,2,0,0,0,2454,106,2348,2454,1211,1243,1976,42,095,014700
42,015100,0000113732158,00006642,2821,2821,0,2821,2599,222,6642,6642,0,0,6642,6603,6504,42,8,35,0,14,39,36,3,0,0,0,6642,108,6534,6642,3330,3312,6504,42,095,015100
42,015201,0000005614296,00006972,2919,2919,0,2919,2745,174,6972,6972,0,0,6972,6922,6839,29,10,23,0,21,50,49,1,0,0,0,6972,111,6861,6972,3316,3656,6839,42,095,015201
42,015202,0000001944376,00000979,417,417,0,417,387,30,979,979,0,0,979,974,969,2,1,0,0,2,5,5,0,0,0,0,979,5,974,979,484,495,969,42,095,015202
42,015300,0000046773006,00004152,1670,1670,0,1670,1601,69,4152,4152,0,0,4152,4139,4117,2,3,4,0,13,13,13,0,0,0,0,4152,28,4124,4152,2001,2151,4117,42,095,015300
42,015400,0000062644912,00003228,1347,1347,0,1347,1223,124,3228,3228,0,0,3228,3214,3173,22,2,8,1,8,14,14,0,0,0,0,3228,32,3196,3228,1659,1569,3173,42,095,015400
42,015500,0000064049031,00005668,2191,2191,0,2191,2130,61,5668,5668,0,0,5668,5649,5603,21,1,16,0,8,19,19,0,0,0,0,5668,38,5630,5668,2790,2878,5603,42,095,015500
42,015600,0000003595716,00003615,1506,1506,0,1506,1427,79,3615,3615,0,0,3615,3586,3536,17,4,20,0,9,29,28,1,0,0,0,3615,44,3571,3615,1723,1892,3536,42,095,015600
42,015700,0000003532377,00002812,1294,1294,0,1294,1221,73,2812,2812,0,0,2812,2793,2745,13,1,19,0,15,19,18,0,1,0,0,2812,45,2767,2812,1321,1491,2745,42,095,015700
42,015800,0000065484138,00006982,2406,2406,0,2406,2333,73,6982,6982,0,0,6982,6942,6861,13,17,27,0,24,40,40,0,0,0,0,6982,70,6912,6982,3508,3474,6861,42,095,015800
42,015901,0000047321568,00005472,2207,2207,0,2207,2134,73,5472,5472,0,0,5472,5449,5409,21,2,8,3,6,23,23,0,0,0,0,5472,69,5403,5472,2739,2733,5409,42,095,015901
42,015902,0000050667580,00003435,1348,1348,0,1348,1258,90,3435,3435,0,0,3435,3429,3392,11,2,10,1,13,6,6,0,0,0,0,3435,20,3415,3435,1790,1645,3392,42,095,015902
42,016001,0000042850724,00005448,2006,2006,0,2006,1954,52,5448,5448,0,0,5448,5423,5370,22,15,9,0,7,25,25,0,0,0,0,5448,36,5412,5448,2762,2686,5370,42,095,016001
42,016002,0000034031048,00004280,1810,1810,0,1810,1726,84,4280,4280,0,0,4280,4263,4229,13,4,8,0,9,17,17,0,0,0,0,4280,36,4244,4280,2171,2109,4229,42,095,016002
42,016100,0000001939962,00002043,865,865,0,865,809,56,2043,2043,0,0,2043,2038,1991,8,7,24,0,8,5,4,1,0,0,0,2043,31,2012,2043,968,1075,1991,42,095,016100
42,016201,0000002880765,00005348,2409,2409,0,2409,2291,118,5348,5348,0,0,5348,5316,5247,15,4,30,0,20,32,31,1,0,0,0,5348,117,5231,5348,2539,2809,5247,42,095,016201
42,016202,0000003849923,00004057,1614,1614,0,1614,1578,36,4057,4057,0,0,4057,4037,3990,18,1,11,0,17,20,20,0,0,0,0,4057,47,4010,4057,1951,2106,3990,42,095,016202
42,016300,0000001905150,00002814,1186,1186,0,1186,1136,50,2814,2814,0,0,2814,2792,2750,13,1,13,2,13,22,22,0,0,0,0,2814,51,2763,2814,1353,1461,2750,42,095,016300
42,016400,0000028726977,00002630,1030,1030,0,1030,1001,29,2630,2630,0,0,2630,2616,2595,5,2,2,1,11,14,14,0,0,0,0,2630,29,2601,2630,1298,1332,2595,42,095,016400
42,016500,0000037362237,00004903,1907,1907,0,1907,1864,43,4903,4903,0,0,4903,4873,4788,24,4,27,5,25,30,29,1,0,0,0,4903,84,4819,4903,2416,2487,4788,42,095,016500
42,016600,0000002342805,00002678,1126,1126,0,1126,1061,65,2678,2678,0,0,2678,2646,2570,40,1,18,0,17,32,28,4,0,0,0,2678,47,2631,2678,1276,1402,2570,42,095,016600
42,016700,0000018983378,00004426,1364,1364,0,1364,1327,37,4426,4426,0,0,4426,4409,4337,27,5,18,0,22,17,17,0,0,0,0,4426,65,4361,4426,1982,2444,4337,42,095,016700
42,016800,0000004328588,00006023,2658,2658,0,2658,2560,98,6023,6023,0,0,6023,6009,5930,33,5,24,0,17,14,13,1,0,0,0,6023,57,5966,6023,2773,3250,5930,42,095,016800
42,016900,0000034703179,00005259,1821,1821,0,1821,1788,33,5259,5259,0,0,5259,5226,5100,47,9,63,0,7,33,32,1,0,0,0,5259,73,5186,5259,2624,2635,5100,42,095,016900
42,017000,0000003926837,00001617,649,649,0,649,631,18,1617,1617,0,0,1617,1613,1600,3,3,2,0,5,4,4,0,0,0,0,1617,11,1606,1617,763,854,1600,42,095,017000
42,017100,0000031231306,00008419,3159,3159,0,3159,3035,124,8419,8419,0,0,8419,8354,7991,189,4,117,1,52,65,62,3,0,0,0,8419,173,8246,8419,4118,4301,7991,42,095,017100
42,017200,0000002479877,00006367,2774,2774,0,2774,2605,169,6367,6367,0,0,6367,6266,5954,116,5,118,2,71,101,92,9,0,0,0,6367,254,6113,6367,3062,3305,5954,42,095,017200
42,017300,0000001547545,00002467,1053,1053,0,1053,1011,42,2467,2467,0,0,2467,2442,2355,47,1,14,1,24,25,25,0,0,0,0,2467,100,2367,2467,1169,1298,2355,42,095,017300
42,017401,0000016083084,00004640,1839,1839,0,1839,1793,46,4640,4640,0,0,4640,4582,4332,96,2,109,3,40,58,58,0,0,0,0,4640,131,4509,4640,2262,2378,4332,42,095,017401
42,017402,0000003487965,00003870,1610,1610,0,1610,1582,28,3870,3870,0,0,3870,3851,3695,68,4,47,1,36,19,18,1,0,0,0,3870,108,3762,3870,1883,1987,3695,42,095,017402
42,017501,0000004187795,00003790,1647,1647,0,1647,1615,32,3790,3790,0,0,3790,3742,3610,61,1,52,0,18,48,45,3,0,0,0,3790,76,3714,3790,1754,2036,3610,42,095,017501
42,017502,0000003962985,00004509,1769,1769,0,1769,1726,43,4509,4509,0,0,4509,4467,4217,135,3,100,0,12,42,40,1,0,1,0,4509,78,4431,4509,2219,2290,4217,42,095,017502
42,017601,0000019868375,00008311,3008,3008,0,3008,2918,90,8311,8311,0,0,8311,8245,7642,216,5,253,1,128,66,60,6,0,0,0,8311,370,7941,8311,3938,4373,7642,42,095,017601
42,017602,0000014734143,00009009,3253,3253,0,3253,3181,72,9009,9009,0,0,9009,8929,8462,206,6,184,1,70,80,78,2,0,0,0,9009,268,8741,9009,4392,4617,8462,42,095,017602
42,017603,0000003169327,00003851,1570,1570,0,1570,1520,50,3851,3851,0,0,3851,3812,3643,94,3,28,0,44,39,39,0,0,0,0,3851,202,3649,3851,1877,1974,3643,42,095,017603
42,017701,0000013331770,00007422,2890,2890,0,2890,2805,85,7422,7422,0,0,7422,7348,6900,78,10,294,0,66,74,71,1,1,1,0,7422,183,7239,7422,3580,3842,6900,42,095,017701
42,017702,0000004132242,00002141,839,839,0,839,828,11,2141,2141,0,0,2141,2101,2040,12,0,34,0,15,40,39,1,0,0,0,2141,54,2087,2141,1055,1086,2040,42,095,017702
42,017800,0000001889368,00001897,721,721,0,721,687,34,1897,1897,0,0,1897,1841,1664,53,6,9,0,109,56,55,1,0,0,0,1897,282,1615,1897,957,940,1664,42,095,017800
42,017901,0000001963021,00003383,1596,1596,0,1596,1498,98,3383,3383,0,0,3383,3367,3315,14,3,10,0,25,16,16,0,0,0,0,3383,96,3287,3383,1592,1791,3315,42,095,017901
42,017902,0000001509851,00002223,974,974,0,974,950,24,2223,2223,0,0,2223,2208,2190,3,1,1,0,13,15,14,1,0,0,0,2223,43,2180,2223,1053,1170,2190,42,095,017902
42,018001,0000042839369,00003923,1485,1485,0,1485,1427,58,3923,3923,0,0,3923,3887,3817,11,5,18,6,30,36,32,4,0,0,0,3923,110,3813,3923,2003,1920,3817,42,095,018001
42,018002,0000019690311,00005961,2430,2430,0,2430,2308,122,5961,5961,0,0,5961,5938,5744,44,11,101,0,38,23,22,0,0,1,0,5961,143,5818,5961,2907,3054,5744,42,095,018002
42,018100,0000049291259,00004837,1888,1888,0,1888,1796,92,4837,4837,0,0,4837,4794,4698,39,2,47,1,7,43,40,3,0,0,0,4837,55,4782,4837,2420,2417,4698,42,095,018100
42,960100,0000105250812,00004230,1657,1657,0,1657,1588,69,4230,4230,0,0,4230,4212,4169,25,2,8,1,7,18,17,1,0,0,0,4230,18,4212,4230,2118,2112,4169,42,097,960100
42,960200,0000080946915,00006910,2905,2905,0,2905,2761,144,6910,6910,0,0,6910,6886,6823,26,12,13,4,8,24,24,0,0,0,0,6910,32,6878,6910,3284,3626,6823,42,097,960200
42,960300,0000009047732,00006659,3006,3006,0,3006,2768,238,6659,6659,0,0,6659,6557,6314,158,8,14,0,63,102,93,9,0,0,0,6659,144,6515,6659,3131,3528,6314,42,097,960300
42,960400,0000054014108,00003488,1549,1549,0,1549,1462,87,3488,3488,0,0,3488,3475,3433,20,4,4,2,12,13,12,1,0,0,0,3488,18,3470,3488,1759,1729,3433,42,097,960400
42,960500,0000065524776,00003735,1528,1528,0,1528,1448,80,3735,3735,0,0,3735,3720,3681,13,8,14,0,4,15,15,0,0,0,0,3735,26,3709,3735,1807,1928,3681,42,097,960500
42,960600,0000004061848,00003714,1772,1772,0,1772,1657,115,3714,3714,0,0,3714,3708,3654,27,5,7,0,15,6,6,0,0,0,0,3714,23,3691,3714,1760,1954,3654,42,097,960600
42,960700,0000081869738,00003050,1268,1268,0,1268,1203,65,3050,3050,0,0,3050,3035,3014,4,0,12,1,4,15,15,0,0,0,0,3050,15,3035,3050,1494,1556,3014,42,097,960700
42,960800,0000137226624,00006280,2649,2649,0,2649,2484,165,6280,6280,0,0,6280,6267,6237,7,3,16,0,4,13,13,0,0,0,0,6280,21,6259,6280,3121,3159,6237,42,097,960800
42,960900,0000056991242,00003436,1625,1625,0,1625,1400,225,3436,3436,0,0,3436,3425,3419,0,1,3,1,1,11,11,0,0,0,0,3436,6,3430,3436,1617,1819,3419,42,097,960900
42,961000,0000000900667,00003448,1916,1916,0,1916,1626,290,3448,3448,0,0,3448,3427,3409,1,5,8,1,3,21,19,2,0,0,0,3448,19,3429,3448,1629,1819,3409,42,097,961000
42,961100,0000000813361,00002942,1713,1713,0,1713,1409,304,2942,2942,0,0,2942,2920,2889,3,5,10,0,13,22,16,0,4,2,0,2942,38,2904,2942,1360,1582,2889,42,097,961100
42,961200,0000065330115,00005608,1752,1752,0,1752,1513,239,5608,5608,0,0,5608,5567,4540,950,5,14,0,58,41,38,3,0,0,0,5608,210,5398,5608,3605,2003,4540,42,097,961200
42,961300,0000001287418,00002619,1318,1318,0,1318,1184,134,2619,2619,0,0,2619,2604,2583,4,1,12,0,4,15,12,3,0,0,0,2619,10,2609,2619,1218,1401,2583,42,097,961300
42,961400,0000001998491,00002401,1163,1163,0,1163,1035,128,2401,2401,0,0,2401,2394,2383,5,1,2,0,3,7,7,0,0,0,0,2401,3,2398,2401,1142,1259,2383,42,097,961400
42,961500,0000000657585,00002489,1527,1527,0,1527,1220,307,2489,2489,0,0,2489,2473,2448,1,2,15,0,7,16,16,0,0,0,0,2489,23,2466,2489,1164,1325,2448,42,097,961500
42,961600,0000000728108,00003013,1704,1704,0,1704,1363,341,3013,3013,0,0,3013,2997,2981,2,6,4,1,3,16,16,0,0,0,0,3013,21,2992,3013,1387,1626,2981,42,097,961600
42,961700,0000000774640,00002507,1443,1443,0,1443,1159,284,2507,2507,0,0,2507,2501,2487,7,0,6,0,1,6,6,0,0,0,0,2507,8,2499,2507,1156,1351,2487,42,097,961700
42,961800,0000118490372,00003659,1611,1611,0,1611,1481,130,3659,3659,0,0,3659,3641,3626,4,3,5,0,3,18,18,0,0,0,0,3659,18,3641,3659,1841,1818,3626,42,097,961800
42,961900,0000153182727,00005856,2351,2351,0,2351,2259,92,5856,5856,0,0,5856,5823,5774,16,3,10,3,17,33,29,4,0,0,0,5856,27,5829,5856,2924,2932,5774,42,097,961900
42,962000,0000001945052,00003844,1803,1803,0,1803,1664,139,3844,3844,0,0,3844,3789,3608,62,5,21,0,93,55,48,7,0,0,0,3844,148,3696,3844,1788,2056,3608,42,097,962000
42,962100,0000000850566,00002779,1450,1450,0,1450,1273,177,2779,2779,0,0,2779,2754,2675,38,3,4,0,34,25,25,0,0,0,0,2779,60,2719,2779,1356,1423,2675,42,097,962100
42,962200,0000002703492,00003987,1819,1819,0,1819,1603,216,3987,3987,0,0,3987,3949,3824,37,7,3,2,76,38,36,2,0,0,0,3987,120,3867,3987,1809,2178,3824,42,097,962200
42,962300,0000244142876,00004917,2103,2103,0,2103,1937,166,4917,4917,0,0,4917,4905,4880,15,1,5,0,4,12,12,0,0,0,0,4917,17,4900,4917,2474,2443,4880,42,097,962300
42,962400,0000002423818,00002985,1532,1532,0,1532,1338,194,2985,2985,0,0,2985,2974,2952,14,0,1,0,7,11,11,0,0,0,0,2985,16,2969,2985,1431,1554,2952,42,097,962400
42,030100,0000200501451,00004653,2092,2092,0,2092,1837,255,4653,4653,0,0,4653,4632,4586,29,5,10,0,2,21,17,4,0,0,0,4653,35,4618,4653,2278,2375,4586,42,099,030100
42,030200,0000182588098,00007500,3311,3311,0,3311,2933,378,7500,7500,0,0,7500,7455,7387,18,13,13,0,24,45,43,1,1,0,0,7500,66,7434,7500,3688,3812,7387,42,099,030200
42,030301,0000056630643,00004521,1956,1956,0,1956,1826,130,4521,4521,0,0,4521,4491,4451,17,6,4,1,12,30,30,0,0,0,0,4521,34,4487,4521,2176,2345,4451,42,099,030301
42,030302,0000084572879,00004648,1824,1824,0,1824,1710,114,4648,4648,0,0,4648,4630,4605,8,4,11,0,2,18,17,1,0,0,0,4648,29,4619,4648,2343,2305,4605,42,099,030302
42,030400,0000072516131,00004633,1975,1975,0,1975,1877,98,4633,4633,0,0,4633,4601,4575,9,0,10,0,7,32,30,2,0,0,0,4633,18,4615,4633,2231,2402,4575,42,099,030400
42,030501,0000089112066,00005095,2036,2036,0,2036,1897,139,5095,5095,0,0,5095,5075,5041,13,6,3,1,11,20,20,0,0,0,0,5095,31,5064,5095,2543,2552,5041,42,099,030501
42,030502,0000154235302,00005307,2137,2137,0,2137,1985,152,5307,5307,0,0,5307,5287,5244,17,7,7,1,11,20,20,0,0,0,0,5307,25,5282,5307,2624,2683,5244,42,099,030502
42,030601,0000212007261,00004262,1908,1908,0,1908,1600,308,4262,4262,0,0,4262,4234,4190,23,8,5,1,7,28,25,3,0,0,0,4262,33,4229,4262,2153,2109,4190,42,099,030601
42,030602,0000381438399,00002983,1702,1702,0,1702,1030,672,2983,2983,0,0,2983,2963,2885,55,4,2,1,16,20,17,3,0,0,0,2983,30,2953,2983,1584,1399,2885,42,099,030602
42,000100,0000000713478,00002650,1900,1900,0,1900,1748,152,2650,2650,0,0,2650,2601,2128,338,6,104,0,25,49,43,6,0,0,0,2650,92,2558,2650,1494,1156,2128,42,101,000100
42,000200,0000000405844,00001362,509,509,0,509,459,50,1362,1362,0,0,1362,1327,162,74,1,1085,1,4,35,33,1,1,0,0,1362,23,1339,1362,683,679,162,42,101,000200
42,000300,0000000563071,00002570,1392,1392,0,1392,1239,153,2570,2570,0,0,2570,2481,1886,379,8,180,2,26,89,85,4,0,0,0,2570,98,2472,2570,1223,1347,1886,42,101,000300
42,000400,0000000521372,00004313,3268,3268,0,3268,2999,269,4313,4313,0,0,4313,4234,3263,552,8,369,2,40,79,73,5,1,0,0,4313,122,4191,4313,1744,2569,3263,42,101,000400
42,000500,0000000431280,00001126,373,373,0,373,280,93,1126,1126,0,0,1126,1109,623,320,2,143,0,21,17,17,0,0,0,0,1126,58,1068,1126,681,445,623,42,101,000500
42,000600,0000000168125,00001315,624,624,0,624,521,103,1315,1315,0,0,1315,1275,915,209,0,140,0,11,40,31,9,0,0,0,1315,45,1270,1315,873,442,915,42,101,000600
42,000700,0000000252815,00002564,2044,2044,0,2044,1890,154,2564,2564,0,0,2564,2498,2038,151,2,282,2,23,66,55,11,0,0,0,2564,117,2447,2564,1207,1357,2038,42,101,000700
42,000800,0000000399716,00008461,6567,6567,0,6567,6115,452,8461,8461,0,0,8461,8331,7133,266,3,855,4,70,130,115,14,1,0,0,8461,296,8165,8461,4049,4412,7133,42,101,000800
42,000900,0000000261466,00004969,3411,3411,0,3411,3195,216,4969,4969,0,0,4969,4862,3474,460,17,835,1,75,107,101,4,1,1,0,4969,211,4758,4969,2470,2499,3474,42,101,000900
42,001000,0000000705692,00005808,3869,3869,0,3869,3635,234,5808,5808,0,0,5808,5754,5290,182,6,221,2,53,54,52,2,0,0,0,5808,144,5664,5808,2794,3014,5290,42,101,001000
42,001100,0000000374636,00005925,4092,4092,0,4092,3857,235,5925,5925,0,0,5925,5778,4773,578,14,354,2,57,147,129,17,1,0,0,5925,231,5694,5925,3095,2830,4773,42,101,001100
42,001200,0000000644762,00008148,5451,5451,0,5451,4973,478,8148,8148,0,0,8148,8024,7000,483,16,430,1,94,124,121,3,0,0,0,8148,307,7841,8148,4179,3969,7000,42,101,001200
42,001300,0000000721568,00004353,2293,2293,0,2293,1922,371,4353,4353,0,0,4353,4275,982,3167,7,58,0,61,78,68,9,1,0,0,4353,97,4256,4353,2079,2274,982,42,101,001300
42,001400,0000000318964,00003585,2270,2270,0,2270,1929,341,3585,3585,0,0,3585,3490,1172,2129,24,114,3,48,95,87,7,0,1,0,3585,135,3450,3585,1866,1719,1172,42,101,001400
42,001500,0000000239512,00002179,1255,1255,0,1255,1135,120,2179,2179,0,0,2179,2097,1375,576,9,102,5,30,82,71,11,0,0,0,2179,86,2093,2179,1176,1003,1375,42,101,001500
42,001600,0000000199559,00001981,1244,1244,0,1244,1122,122,1981,1981,0,0,1981,1926,1653,162,1,71,3,36,55,48,6,1,0,0,1981,93,1888,1981,1043,938,1653,42,101,001600
42,001700,0000000205748,00002415,1500,1500,0,1500,1365,135,2415,2415,0,0,2415,2368,1905,383,9,50,0,21,47,45,1,1,0,0,2415,84,2331,2415,1191,1224,1905,42,101,001700
42,001800,0000000239288,00002398,1318,1318,0,1318,1208,110,2398,2398,0,0,2398,2334,1645,525,6,134,0,24,64,49,14,0,1,0,2398,70,2328,2398,1138,1260,1645,42,101,001800
42,001900,0000000328120,00002686,1381,1381,0,1381,1061,320,2686,2686,0,0,2686,2635,119,2407,12,36,2,59,51,46,5,0,0,0,2686,118,2568,2686,1274,1412,119,42,101,001900
42,002000,0000000289664,00002334,1066,1066,0,1066,890,176,2334,2334,0,0,2334,2319,22,2266,10,20,0,1,15,11,4,0,0,0,2334,11,2323,2334,1051,1283,22,42,101,002000
42,002100,0000000238214,00002340,1149,1149,0,1149,883,266,2340,2340,0,0,2340,2308,41,2238,16,13,0,0,32,24,8,0,0,0,2340,15,2325,2340,1022,1318,41,42,101,002100
42,002200,0000000235397,00002182,1194,1194,0,1194,928,266,2182,2182,0,0,2182,2145,283,1752,6,74,0,30,37,33,4,0,0,0,2182,88,2094,2182,1057,1125,283,42,101,002200
42,002300,0000000211493,00002480,1302,1302,0,1302,1145,157,2480,2480,0,0,2480,2407,1750,221,2,396,1,37,73,72,1,0,0,0,2480,115,2365,2480,1230,1250,1750,42,101,002300
42,002400,0000000536354,00004426,2362,2362,0,2362,2028,334,4426,4426,0,0,4426,4318,2654,779,10,796,0,79,108,98,8,2,0,0,4426,274,4152,4426,2193,2233,2654,42,101,002400
42,002500,0000000398533,00003149,1640,1640,0,1640,1367,273,3149,3149,0,0,3149,3060,1546,1380,8,102,0,24,89,81,7,1,0,0,3149,133,3016,3149,1495,1654,1546,42,101,002500
42,002600,0000000460257,00000000,1,1,0,1,0,1,0,0,0,0,0,0,0,0,0,0,0,0,0,0,0,0,0,0,0,0,0,0,0,0,0,42,101,002600
42,002700,0000000593414,00007658,3505,3505,0,3505,2975,530,7658,7658,0,0,7658,7464,4312,1674,18,1119,9,332,194,185,8,1,0,0,7658,683,6975,7658,3598,4060,4312,42,101,002700
42,002800,0000000593235,00009255,4117,4117,0,4117,3643,474,9255,9255,0,0,9255,8971,5569,719,17,2369,10,287,284,280,4,0,0,0,9255,701,8554,9255,4347,4908,5569,42,101,002800
42,002900,0000000364775,00004050,2167,2167,0,2167,1979,188,4050,4050,0,0,4050,3933,3557,82,7,213,1,73,117,117,0,0,0,0,4050,181,3869,4050,1930,2120,3557,42,101,002900
42,003000,0000000469448,00008160,3314,3314,0,3314,2811,503,8160,8160,0,0,8160,7956,1203,3986,16,2625,12,114,204,197,7,0,0,0,8160,244,7916,8160,3871,4289,1203,42,101,003000
42,003100,0000000395528,00005161,2527,2527,0,2527,1993,534,5161,5161,0,0,5161,5101,55,4932,15,75,3,21,60,53,7,0,0,0,5161,44,5117,5161,2289,2872,55,42,101,003100
42,003200,0000000493303,00005587,2357,2357,0,2357,1956,401,5587,5587,0,0,5587,5500,479,4968,18,19,0,16,87,78,8,1,0,0,5587,58,5529,5587,2441,3146,479,42,101,003200
42,003300,0000000740310,00006235,2603,2603,0,2603,2224,379,6235,6235,0,0,6235,6164,2633,3437,10,30,0,54,71,63,6,1,1,0,6235,113,6122,6235,2775,3460,2633,42,101,003300
42,003400,0000000547294,00000363,202,202,0,202,162,40,363,363,0,0,363,362,88,153,0,121,0,0,1,1,0,0,0,0,363,6,357,363,173,190,88,42,101,003400
42,003500,0000001697729,00000126,78,78,0,78,58,20,126,126,0,0,126,124,94,29,0,0,0,1,2,1,1,0,0,0,126,1,125,126,58,68,94,42,101,003500
42,003600,0000000889844,00005724,3073,3073,0,3073,2401,672,5724,5724,0,0,5724,5632,2035,3358,3,206,3,27,92,80,11,1,0,0,5724,95,5629,5724,2402,3322,2035,42,101,003600
42,003701,0000000359119,00007061,2631,2631,0,2631,2315,316,7061,7061,0,0,7061,6939,865,5385,18,602,2,67,122,114,7,1,0,0,7061,113,6948,7061,3072,3989,865,42,101,003701
42,003702,0000000251713,00003372,1461,1461,0,1461,1360,101,3372,3372,0,0,3372,3311,1954,1128,8,196,3,22,61,60,1,0,0,0,3372,77,3295,3372,1542,1830,1954,42,101,003702
42,003800,0000000689756,00003851,1721,1721,0,1721,1652,69,3851,3851,0,0,3851,3782,3658,65,4,44,0,11,69,68,1,0,0,0,3851,49,3802,3851,1769,2082,3658,42,101,003800
42,003901,0000000430434,00006192,2916,2916,0,2916,2681,235,6192,6192,0,0,6192,6103,4712,693,16,610,1,71,89,82,7,0,0,0,6192,176,6016,6192,2891,3301,4712,42,101,003901
42,003902,0000000467092,00005630,2588,2588,0,2588,2435,153,5630,5630,0,0,5630,5587,5539,4,3,34,0,7,43,43,0,0,0,0,5630,70,5560,5630,2639,2991,5539,42,101,003902
42,004001,0000000315874,00004036,2079,2079,0,2079,1877,202,4036,4036,0,0,4036,3938,3725,46,13,113,1,40,98,97,0,1,0,0,4036,136,3900,4036,1868,2168,3725,42,101,004001
42,004002,0000000331227,00005024,2320,2320,0,2320,2193,127,5024,5024,0,0,5024,4981,4932,16,3,18,0,12,43,43,0,0,0,0,5024,91,4933,5024,2264,2760,4932,42,101,004002
42,004101,0000000382086,00005737,2470,2470,0,2470,2018,452,5737,5737,0,0,5737,5503,2021,1876,24,1419,0,163,234,223,11,0,0,0,5737,336,5401,5737,2710,3027,2021,42,101,004101
42,004102,0000000392855,00007316,2999,2999,0,2999,2665,334,7316,7316,0,0,7316,7075,4804,828,19,1281,20,123,241,234,5,0,0,2,7316,355,6961,7316,3524,3792,4804,42,101,004102
42,004201,0000000360974,00005449,2317,2317,0,2317,2087,230,5449,5449,0,0,5449,5337,4365,512,7,361,5,87,112,110,2,0,0,0,5449,268,5181,5449,2544,2905,4365,42,101,004201
42,004202,0000000443043,00005053,1926,1926,0,1926,1775,151,5053,5053,0,0,5053,4959,4370,275,12,262,7,33,94,91,0,3,0,0,5053,120,4933,5053,2392,2661,4370,42,101,004202
42,004300,0000001885301,00000000,0,0,0,0,0,0,0,0,0,0,0,0,0,0,0,0,0,0,0,0,0,0,0,0,0,0,0,0,0,0,0,42,101,004300
42,004400,0000000577594,00001088,443,443,0,443,393,50,1088,1088,0,0,1088,1061,624,276,0,149,1,11,27,26,1,0,0,0,1088,46,1042,1088,485,603,624,42,101,004400
42,004500,0000000497488,00003066,1431,1431,0,1431,1379,52,3066,3066,0,0,3066,3022,2950,14,1,36,0,21,44,44,0,0,0,0,3066,32,3034,3066,1407,1659,2950,42,101,004500
42,004600,0000003738089,00000185,652,652,0,652,68,584,185,185,0,0,185,177,12,160,2,1,0,2,8,8,0,0,0,0,185,6,179,185,79,106,12,42,101,004600
42,004700,0000000834342,00002561,1522,1522,0,1522,1105,417,2561,2561,0,0,2561,2545,2474,48,1,13,0,9,16,16,0,0,0,0,2561,19,2542,2561,1199,1362,2474,42,101,004700
42,004800,0000000453752,00000472,221,221,0,221,215,6,472,472,0,0,472,471,469,2,0,0,0,0,1,1,0,0,0,0,472,0,472,472,211,261,469,42,101,004800
42,004900,0000004421765,00000000,0,0,0,0,0,0,0,0,0,0,0,0,0,0,0,0,0,0,0,0,0,0,0,0,0,0,0,0,0,0,0,42,101,004900
42,005000,0000004477136,00000000,340,340,0,340,0,340,0,0,0,0,0,0,0,0,0,0,0,0,0,0,0,0,0,0,0,0,0,0,0,0,0,42,101,005000
42,005100,0000002429968,00000611,514,514,0,514,372,142,611,611,0,0,611,595,151,400,2,31,0,11,16,14,2,0,0,0,611,28,583,611,322,289,151,42,101,005100
42,005200,0000008466490,00000001,0,0,0,0,0,0,1,1,0,0,1,1,1,0,0,0,0,0,0,0,0,0,0,0,1,0,1,1,1,0,1,42,101,005200
42,005400,0000001767086,00001248,691,691,0,691,598,93,1248,1248,0,0,1248,1223,151,1036,3,24,0,9,25,19,6,0,0,0,1248,27,1221,1248,616,632,151,42,101,005400
42,005500,0000001200066,00005777,2473,2473,0,2473,2354,119,5777,5777,0,0,5777,5651,1717,3735,10,135,2,52,126,116,10,0,0,0,5777,131,5646,5777,2687,3090,1717,42,101,005500
42,005600,0000000839138,00001230,577,577,0,577,545,32,1230,1230,0,0,1230,1213,86,1092,5,18,0,12,17,14,3,0,0,0,1230,32,1198,1230,524,706,86,42,101,005600
42,005700,0000001288775,00000000,0,0,0,0,0,0,0,0,0,0,0,0,0,0,0,0,0,0,0,0,0,0,0,0,0,0,0,0,0,0,0,42,101,005700
42,005800,0000003755529,00000000,0,0,0,0,0,0,0,0,0,0,0,0,0,0,0,0,0,0,0,0,0,0,0,0,0,0,0,0,0,0,0,42,101,005800
42,005900,0000000390757,00000000,0,0,0,0,0,0,0,0,0,0,0,0,0,0,0,0,0,0,0,0,0,0,0,0,0,0,0,0,0,0,0,42,101,005900
42,006000,0000001086456,00006127,2642,2642,0,2642,2476,166,6127,6127,0,0,6127,5976,3333,2405,10,201,0,27,151,137,13,0,1,0,6127,85,6042,6127,2794,3333,3333,42,101,006000
42,006100,0000000534974,00002957,1202,1202,0,1202,1157,45,2957,2957,0,0,2957,2908,1580,1189,2,111,0,26,49,48,1,0,0,0,2957,52,2905,2957,1371,1586,1580,42,101,006100
42,006200,0000000505813,00004127,1600,1600,0,1600,1459,141,4127,4127,0,0,4127,4053,1980,1752,18,272,0,31,74,67,4,3,0,0,4127,77,4050,4127,1926,2201,1980,42,101,006200
42,006300,0000000555191,00004546,1730,1730,0,1730,1428,302,4546,4546,0,0,4546,4438,694,2959,5,749,0,31,108,102,6,0,0,0,4546,112,4434,4546,2171,2375,694,42,101,006300
42,006400,0000000660331,00004658,1672,1672,0,1672,1490,182,4658,4658,0,0,4658,4533,956,2777,15,760,0,25,125,112,13,0,0,0,4658,108,4550,4658,2175,2483,956,42,101,006400
42,006500,0000001159143,00005231,2249,2249,0,2249,1852,397,5231,5231,0,0,5231,5172,52,5053,10,32,7,18,59,47,11,1,0,0,5231,69,5162,5231,2337,2894,52,42,101,006500
42,006600,0000000656719,00003979,1595,1595,0,1595,1339,256,3979,3979,0,0,3979,3870,478,2799,10,566,2,15,109,106,2,1,0,0,3979,99,3880,3979,1764,2215,478,42,101,006600
42,006700,0000000998660,00006991,2769,2769,0,2769,2485,284,6991,6991,0,0,6991,6865,2830,3582,6,369,2,76,126,120,6,0,0,0,6991,164,6827,6991,3191,3800,2830,42,101,006700
42,006800,0000000743960,00000001,1,1,0,1,1,0,1,1,0,0,1,0,0,0,0,0,0,0,1,1,0,0,0,0,1,0,1,1,1,0,0,42,101,006800
42,006900,0000000691145,00002710,1125,1125,0,1125,1026,99,2710,2710,0,0,2710,2688,114,2546,3,1,1,23,22,20,2,0,0,0,2710,21,2689,2710,1085,1625,114,42,101,006900
42,007000,0000000466727,00004588,1850,1850,0,1850,1542,308,4588,4588,0,0,4588,4527,33,4424,15,29,0,26,61,49,10,2,0,0,4588,43,4545,4588,2018,2570,33,42,101,007000
42,007100,0000000672090,00008310,3227,3227,0,3227,2753,474,8310,8310,0,0,8310,8164,188,7848,13,61,6,48,146,127,9,10,0,0,8310,112,8198,8310,3674,4636,188,42,101,007100
42,007200,0000000488103,00005421,2127,2127,0,2127,1825,302,5421,5421,0,0,5421,5353,82,5214,10,21,0,26,68,68,0,0,0,0,5421,62,5359,5421,2384,3037,82,42,101,007200
42,007300,0000000392081,00003255,1366,1366,0,1366,1093,273,3255,3255,0,0,3255,3200,37,3105,9,40,0,9,55,48,7,0,0,0,3255,36,3219,3255,1482,1773,37,42,101,007300
42,007400,0000000675281,00004559,2077,2077,0,2077,1645,432,4559,4559,0,0,4559,4463,98,4296,13,43,2,11,96,94,1,1,0,0,4559,36,4523,4559,2026,2533,98,42,101,007400
42,007500,0000000418043,00000000,0,0,0,0,0,0,0,0,0,0,0,0,0,0,0,0,0,0,0,0,0,0,0,0,0,0,0,0,0,0,0,42,101,007500
42,007600,0000001004150,00002419,2,2,0,2,2,0,2419,2419,0,0,2419,2371,1458,344,0,502,0,67,48,47,1,0,0,0,2419,143,2276,2419,1474,945,1458,42,101,007600
42,007700,0000000322756,00001850,888,888,0,888,802,86,1850,1850,0,0,1850,1803,612,857,13,295,0,26,47,39,8,0,0,0,1850,51,1799,1850,847,1003,612,42,101,007700
42,007800,0000000435912,00004690,2421,2421,0,2421,2118,303,4690,4690,0,0,4690,4464,1339,2901,14,164,4,42,226,215,11,0,0,0,4690,125,4565,4690,2256,2434,1339,42,101,007800
42,007900,0000000378232,00004777,2392,2392,0,2392,2150,242,4777,4777,0,0,4777,4618,1309,3037,9,200,3,60,159,153,6,0,0,0,4777,129,4648,4777,2360,2417,1309,42,101,007900
42,008000,0000000427154,00004481,1962,1962,0,1962,1612,350,4481,4481,0,0,4481,4430,92,4289,8,31,0,10,51,48,1,2,0,0,4481,35,4446,4481,2007,2474,92,42,101,008000
42,008100,0000000614663,00008288,3299,3299,0,3299,3020,279,8288,8288,0,0,8288,8146,52,8020,10,29,1,34,142,127,14,0,1,0,8288,73,8215,8288,3532,4756,52,42,101,008100
42,008200,0000000832845,00007297,2960,2960,0,2960,2724,236,7297,7297,0,0,7297,7175,64,7025,21,40,2,23,122,98,20,2,2,0,7297,83,7214,7297,3208,4089,64,42,101,008200
42,008301,0000000515960,00004420,1942,1942,0,1942,1748,194,4420,4420,0,0,4420,4361,113,4151,14,60,1,22,59,49,6,2,2,0,4420,60,4360,4420,1915,2505,113,42,101,008301
42,008302,0000000427987,00004535,2204,2204,0,2204,1814,390,4535,4535,0,0,4535,4465,58,4357,11,22,0,17,70,63,6,1,0,0,4535,60,4475,4535,1974,2561,58,42,101,008302
42,008400,0000000496792,00004798,2052,2052,0,2052,1791,261,4798,4798,0,0,4798,4708,56,4617,11,14,2,8,90,78,10,2,0,0,4798,32,4766,4798,2060,2738,56,42,101,008400
42,008500,0000000622072,00006539,3166,3166,0,3166,2639,527,6539,6539,0,0,6539,6411,56,6241,22,52,2,38,128,120,6,2,0,0,6539,88,6451,6539,2813,3726,56,42,101,008500
42,008600,0000000625431,00006224,3335,3335,0,3335,2848,487,6224,6224,0,0,6224,6030,949,4720,8,300,1,52,194,177,13,4,0,0,6224,163,6061,6224,2877,3347,949,42,101,008600
42,008700,0000000541792,00006733,3791,3791,0,3791,3391,400,6733,6733,0,0,6733,6412,3072,1957,28,1246,3,106,321,309,12,0,0,0,6733,235,6498,6733,3496,3237,3072,42,101,008700
42,008800,0000000570696,00008307,2445,2445,0,2445,2148,297,8307,8307,0,0,8307,8095,4795,1107,14,2025,6,148,212,205,7,0,0,0,8307,344,7963,8307,4292,4015,4795,42,101,008800
42,008900,0000000873888,00003226,499,499,0,499,491,8,3226,3226,0,0,3226,3165,1622,474,7,977,7,78,61,58,3,0,0,0,3226,176,3050,3226,1625,1601,1622,42,101,008900
42,009000,0000000450386,00005452,1637,1637,0,1637,1572,65,5452,5452,0,0,5452,5249,3562,992,18,598,21,58,203,196,7,0,0,0,5452,208,5244,5452,3045,2407,3562,42,101,009000
42,009100,0000000421935,00002812,1619,1619,0,1619,1482,137,2812,2812,0,0,2812,2732,836,1521,18,302,5,50,80,74,6,0,0,0,2812,90,2722,2812,1371,1441,836,42,101,009100
42,009200,0000000514519,00003075,1447,1447,0,1447,1142,305,3075,3075,0,0,3075,3011,74,2869,7,49,0,12,64,58,5,0,1,0,3075,39,3036,3075,1368,1707,74,42,101,009200
42,009300,0000000402721,00004609,2296,2296,0,2296,1843,453,4609,4609,0,0,4609,4566,29,4489,13,6,1,28,43,41,2,0,0,0,4609,41,4568,4609,2030,2579,29,42,101,009300
42,009400,0000000373494,00003871,1970,1970,0,1970,1659,311,3871,3871,0,0,3871,3809,18,3753,20,5,2,11,62,51,10,1,0,0,3871,34,3837,3871,1616,2255,18,42,101,009400
42,009500,0000000324353,00003588,1666,1666,0,1666,1366,300,3588,3588,0,0,3588,3548,12,3500,18,6,2,10,40,34,6,0,0,0,3588,28,3560,3588,1572,2016,12,42,101,009500
42,009600,0000000408934,00004504,2102,2102,0,2102,1717,385,4504,4504,0,0,4504,4446,71,4317,10,43,0,5,58,49,9,0,0,0,4504,32,4472,4504,2008,2496,71,42,101,009600
42,009700,0000002133199,00000035,18,18,0,18,18,0,35,35,0,0,35,35,22,13,0,0,0,0,0,0,0,0,0,0,35,1,34,35,19,16,22,42,101,009700
42,009800,0000000904480,00007768,3260,3260,0,3260,3105,155,7768,7768,0,0,7768,7527,2578,4566,27,284,0,72,241,223,9,8,1,0,7768,157,7611,7768,3506,4262,2578,42,101,009800
42,009900,0000000206222,00000381,142,142,0,142,140,2,381,381,0,0,381,379,218,153,0,8,0,0,2,2,0,0,0,0,381,1,380,381,171,210,218,42,101,009900
42,010000,0000000552742,00004218,1775,1775,0,1775,1614,161,4218,4218,0,0,4218,4141,1435,2539,16,82,0,69,77,71,6,0,0,0,4218,157,4061,4218,1901,2317,1435,42,101,010000
42,010100,0000000603280,00005841,2659,2659,0,2659,2260,399,5841,5841,0,0,5841,5713,166,5455,21,32,0,39,128,115,13,0,0,0,5841,111,5730,5841,2558,3283,166,42,101,010100
42,010200,0000000358476,00003208,1470,1470,0,1470,1284,186,3208,3208,0,0,3208,3126,9,3091,4,11,0,11,82,72,10,0,0,0,3208,39,3169,3208,1404,1804,9,42,101,010200
42,010300,0000000283120,00002588,1224,1224,0,1224,988,236,2588,2588,0,0,2588,2556,27,2492,13,13,1,10,32,29,3,0,0,0,2588,22,2566,2588,1111,1477,27,42,101,010300
42,010400,0000000467647,00003498,1522,1522,0,1522,1283,239,3498,3498,0,0,3498,3456,19,3412,3,5,0,17,42,30,10,0,2,0,3498,32,3466,3498,1494,2004,19,42,101,010400
42,010500,0000000664028,00003503,1688,1688,0,1688,1285,403,3503,3503,0,0,3503,3474,71,3362,13,17,2,9,29,20,9,0,0,0,3503,39,3464,3503,1457,2046,71,42,101,010500
42,010600,0000000258496,00001565,756,756,0,756,613,143,1565,1565,0,0,1565,1526,19,1498,6,1,0,2,39,36,3,0,0,0,1565,18,1547,1565,695,870,19,42,101,010600
42,010700,0000000462992,00003671,1639,1639,0,1639,1276,363,3671,3671,0,0,3671,3641,45,3556,9,6,11,14,30,25,5,0,0,0,3671,46,3625,3671,1619,2052,45,42,101,010700
42,010800,0000000559249,00004273,1845,1845,0,1845,1460,385,4273,4273,0,0,4273,4202,62,4074,30,23,2,11,71,66,5,0,0,0,4273,70,4203,4273,1872,2401,62,42,101,010800
42,010900,0000000255737,00002553,1101,1101,0,1101,985,116,2553,2553,0,0,2553,2507,83,2370,18,24,1,11,46,43,3,0,0,0,2553,19,2534,2553,1106,1447,83,42,101,010900
42,011000,0000000488980,00003817,2007,2007,0,2007,1527,480,3817,3817,0,0,3817,3779,66,3669,5,15,3,21,38,33,5,0,0,0,3817,63,3754,3817,1759,2058,66,42,101,011000
42,011100,0000001316710,00004204,1961,1961,0,1961,1502,459,4204,4204,0,0,4204,4128,106,3982,10,18,5,7,76,62,14,0,0,0,4204,43,4161,4204,1867,2337,106,42,101,011100
42,011200,0000000506361,00006107,2506,2506,0,2506,2208,298,6107,6107,0,0,6107,6012,33,5924,13,17,4,21,95,76,17,0,2,0,6107,94,6013,6107,2653,3454,33,42,101,011200
42,011300,0000000345034,00003132,1381,1381,0,1381,1213,168,3132,3132,0,0,3132,3081,18,3038,11,6,0,8,51,43,8,0,0,0,3132,36,3096,3132,1337,1795,18,42,101,011300
42,011400,0000000976261,00006612,2976,2976,0,2976,2659,317,6612,6612,0,0,6612,6511,249,6178,23,32,1,28,101,88,13,0,0,0,6612,58,6554,6612,2939,3673,249,42,101,011400
42,011500,0000000359134,00004274,1706,1706,0,1706,1556,150,4274,4274,0,0,4274,4168,1110,2979,4,45,1,29,106,88,16,2,0,0,4274,83,4191,4274,1922,2352,1110,42,101,011500
42,011600,0000000747363,00004033,1423,1423,0,1423,1346,77,4033,4033,0,0,4033,3939,2468,1275,4,148,1,43,94,86,8,0,0,0,4033,120,3913,4033,1908,2125,2468,42,101,011600
42,011700,0000000664749,00002738,504,504,0,504,488,16,2738,2738,0,0,2738,2695,1785,836,8,52,0,14,43,40,3,0,0,0,2738,70,2668,2738,1220,1518,1785,42,101,011700
42,011800,0000000938645,00005987,2324,2324,0,2324,2181,143,5987,5987,0,0,5987,5861,106,5713,20,9,0,13,126,117,6,3,0,0,5987,48,5939,5987,2670,3317,106,42,101,011800
42,011900,0000000695411,00005596,2448,2448,0,2448,2203,245,5596,5596,0,0,5596,5471,120,5275,11,38,2,25,125,105,9,11,0,0,5596,65,5531,5596,2504,3092,120,42,101,011900
42,012000,0000000599778,00001661,759,759,0,759,721,38,1661,1661,0,0,1661,1617,401,1139,5,59,0,13,44,34,10,0,0,0,1661,28,1633,1661,835,826,401,42,101,012000
42,012100,0000000893865,00003340,1453,1453,0,1453,1392,61,3340,3340,0,0,3340,3245,1119,1970,11,92,6,47,95,77,18,0,0,0,3340,107,3233,3340,1390,1950,1119,42,101,012100
42,012200,0000001430152,00008016,5601,5601,0,5601,4856,745,8016,8016,0,0,8016,7814,3973,2988,23,754,10,66,202,171,30,1,0,0,8016,228,7788,8016,3187,4829,3973,42,101,012200
42,012300,0000005513258,00000016,1,1,0,1,1,0,16,16,0,0,16,16,14,2,0,0,0,0,0,0,0,0,0,0,16,0,16,16,8,8,14,42,101,012300
42,012400,0000001179331,00000000,0,0,0,0,0,0,0,0,0,0,0,0,0,0,0,0,0,0,0,0,0,0,0,0,0,0,0,0,0,0,0,42,101,012400
42,012500,0000000834652,00004352,3002,3002,0,3002,2651,351,4352,4352,0,0,4352,4259,3069,646,11,449,0,84,93,83,10,0,0,0,4352,209,4143,4352,1971,2381,3069,42,101,012500
42,012600,0000000365187,00000835,436,436,0,436,351,85,835,835,0,0,835,809,355,309,2,127,0,16,26,22,4,0,0,0,835,67,768,835,513,322,355,42,101,012600
42,012700,0000000339249,00000727,272,272,0,272,255,17,727,727,0,0,727,719,44,435,1,209,0,30,8,8,0,0,0,0,727,55,672,727,402,325,44,42,101,012700
42,012800,0000000258247,00000236,165,165,0,165,145,20,236,236,0,0,236,232,197,15,0,13,0,7,4,4,0,0,0,0,236,14,222,236,133,103,197,42,101,012800
42,012900,0000000358427,00000553,373,373,0,373,329,44,553,553,0,0,553,543,426,75,0,11,0,31,10,10,0,0,0,0,553,58,495,553,320,233,426,42,101,012900
42,013000,0000000207550,00000994,537,537,0,537,477,60,994,994,0,0,994,969,386,499,3,7,0,74,25,22,1,2,0,0,994,125,869,994,486,508,386,42,101,013000
42,013100,0000000320911,00001676,843,843,0,843,688,155,1676,1676,0,0,1676,1643,79,1503,6,10,1,44,33,25,5,3,0,0,1676,78,1598,1676,696,980,79,42,101,013100
42,013200,0000000433616,00002158,1198,1198,0,1198,704,494,2158,2158,0,0,2158,2139,118,1929,3,36,2,51,19,19,0,0,0,0,2158,101,2057,2158,1001,1157,118,42,101,013200
42,013300,0000000360277,00002249,1248,1248,0,1248,1017,231,2249,2249,0,0,2249,2192,549,1362,14,58,0,209,57,54,3,0,0,0,2249,359,1890,2249,1150,1099,549,42,101,013300
42,013400,0000000424844,00005386,3352,3352,0,3352,3062,290,5386,5386,0,0,5386,5263,3973,874,11,120,4,281,123,111,10,2,0,0,5386,549,4837,5386,2593,2793,3973,42,101,013400
42,013500,0000000405925,00003437,1491,1491,0,1491,1351,140,3437,3437,0,0,3437,3376,1309,1794,4,39,2,228,61,57,4,0,0,0,3437,344,3093,3437,1595,1842,1309,42,101,013500
42,013600,0000000403252,00005962,3497,3497,0,3497,3174,323,5962,5962,0,0,5962,5819,5036,520,6,175,9,73,143,139,4,0,0,0,5962,172,5790,5962,2919,3043,5036,42,101,013600
42,013700,0000000605749,00005052,2507,2507,0,2507,1893,614,5052,5052,0,0,5052,4994,286,4661,8,18,0,21,58,55,3,0,0,0,5052,75,4977,5052,2271,2781,286,42,101,013700
42,013800,0000000350601,00002339,1208,1208,0,1208,894,314,2339,2339,0,0,2339,2317,59,2237,6,3,0,12,22,20,1,1,0,0,2339,30,2309,2339,1064,1275,59,42,101,013800
42,013900,0000000567290,00002716,1345,1345,0,1345,849,496,2716,2716,0,0,2716,2671,206,2398,4,12,1,50,45,42,3,0,0,0,2716,106,2610,2716,1219,1497,206,42,101,013900
42,014000,0000000429220,00003011,1697,1697,0,1697,1192,505,3011,3011,0,0,3011,2952,126,2725,5,46,0,50,59,45,12,2,0,0,3011,106,2905,3011,1406,1605,126,42,101,014000
42,014100,0000000571311,00002303,1317,1317,0,1317,935,382,2303,2303,0,0,2303,2260,231,1878,8,9,0,134,43,43,0,0,0,0,2303,261,2042,2303,1004,1299,231,42,101,014100
42,014200,0000000795484,00002171,1201,1201,0,1201,983,218,2171,2171,0,0,2171,2076,1162,634,5,25,3,247,95,79,14,2,0,0,2171,494,1677,2171,1120,1051,1162,42,101,014200
42,014300,0000000552435,00001449,734,734,0,734,624,110,1449,1449,0,0,1449,1408,1301,69,0,13,3,22,41,35,5,1,0,0,1449,66,1383,1449,706,743,1301,42,101,014300
42,014400,0000000619087,00003217,1377,1377,0,1377,1152,225,3217,3217,0,0,3217,3032,1224,950,15,46,8,789,185,171,13,1,0,0,3217,1387,1830,3217,1578,1639,1224,42,101,014400
42,014500,0000000324608,00001431,702,702,0,702,538,164,1431,1431,0,0,1431,1400,103,1048,1,0,1,247,31,31,0,0,0,0,1431,403,1028,1431,591,840,103,42,101,014500
42,014600,0000000456701,00003260,967,967,0,967,920,47,3260,3260,0,0,3260,3218,693,2359,9,112,1,44,42,40,2,0,0,0,3260,103,3157,3260,1342,1918,693,42,101,014600
42,014700,0000000343753,00002338,1160,1160,0,1160,755,405,2338,2338,0,0,2338,2319,34,2252,3,16,1,13,19,15,1,3,0,0,2338,41,2297,2338,1075,1263,34,42,101,014700
42,014800,0000000190661,00000742,598,598,0,598,342,256,742,742,0,0,742,742,8,732,2,0,0,0,0,0,0,0,0,0,742,3,739,742,365,377,8,42,101,014800
42,014900,0000000449613,00004634,2253,2253,0,2253,1739,514,4634,4634,0,0,4634,4577,31,4513,11,15,0,7,57,55,2,0,0,0,4634,63,4571,4634,2058,2576,31,42,101,014900
42,015000,0000002395722,00000110,58,58,0,58,55,3,110,110,0,0,110,109,38,71,0,0,0,0,1,1,0,0,0,0,110,0,110,110,52,58,38,42,101,015000
42,015100,0000000742467,00008018,3878,3878,0,3878,3044,834,8018,8018,0,0,8018,7950,29,7862,25,19,0,15,68,56,10,1,1,0,8018,78,7940,8018,3425,4593,29,42,101,015100
42,015200,0000000658969,00005167,2374,2374,0,2374,1602,772,5167,5167,0,0,5167,5118,37,5029,8,12,0,32,49,42,5,2,0,0,5167,89,5078,5167,2256,2911,37,42,101,015200
42,015300,0000000463065,00003382,1706,1706,0,1706,1176,530,3382,3382,0,0,3382,3347,263,2976,11,84,2,11,35,34,1,0,0,0,3382,47,3335,3382,1553,1829,263,42,101,015300
42,015400,0000000310278,00002258,230,230,0,230,188,42,2258,2258,0,0,2258,2232,811,1167,2,126,7,119,26,23,2,1,0,0,2258,62,2196,2258,939,1319,811,42,101,015400
42,015500,0000000420654,00002941,1115,1115,0,1115,852,263,2941,2941,0,0,2941,2885,273,2191,18,13,0,390,56,55,1,0,0,0,2941,725,2216,2941,1284,1657,273,42,101,015500
42,015600,0000000429988,00001992,702,702,0,702,588,114,1992,1992,0,0,1992,1877,291,444,6,10,6,1120,115,115,0,0,0,0,1992,1449,543,1992,993,999,291,42,101,015600
42,015700,0000000491690,00002732,1037,1037,0,1037,868,169,2732,2732,0,0,2732,2511,1089,276,19,58,5,1064,221,213,8,0,0,0,2732,1585,1147,2732,1309,1423,1089,42,101,015700
42,015800,0000000594738,00005854,2575,2575,0,2575,2265,310,5854,5854,0,0,5854,5728,5365,138,13,104,0,108,126,122,4,0,0,0,5854,227,5627,5854,2857,2997,5365,42,101,015800
42,015900,0000000529864,00001817,819,819,0,819,686,133,1817,1817,0,0,1817,1797,1746,32,6,2,0,11,20,20,0,0,0,0,1817,53,1764,1817,886,931,1746,42,101,015900
42,016000,0000000718178,00007406,3051,3051,0,3051,2661,390,7406,7406,0,0,7406,7205,6881,87,23,90,5,119,201,199,2,0,0,0,7406,295,7111,7406,3592,3814,6881,42,101,016000
42,016100,0000000692921,00005548,2253,2253,0,2253,1830,423,5548,5548,0,0,5548,5348,3324,464,37,811,3,709,200,196,4,0,0,0,5548,1268,4280,5548,2817,2731,3324,42,101,016100
42,016200,0000000351050,00002329,870,870,0,870,719,151,2329,2329,0,0,2329,2204,516,620,40,26,1,1001,125,109,15,1,0,0,2329,1676,653,2329,1138,1191,516,42,101,016200
42,016300,0000000568344,00003629,1294,1294,0,1294,1062,232,3629,3629,0,0,3629,3461,660,614,34,231,8,1914,168,166,2,0,0,0,3629,2664,965,3629,1747,1882,660,42,101,016300
42,016400,0000000480204,00005233,1780,1780,0,1780,1538,242,5233,5233,0,0,5233,4978,734,2377,9,15,0,1843,255,231,24,0,0,0,5233,2852,2381,5233,2416,2817,734,42,101,016400
42,016500,0000000400786,00002722,1398,1398,0,1398,904,494,2722,2722,0,0,2722,2667,61,2555,7,8,0,36,55,40,15,0,0,0,2722,132,2590,2722,1245,1477,61,42,101,016500
42,016600,0000000254725,00001699,842,842,0,842,662,180,1699,1699,0,0,1699,1669,45,1600,5,3,0,16,30,24,3,3,0,0,1699,27,1672,1699,937,762,45,42,101,016600
42,016700,0000000612550,00006947,3320,3320,0,3320,2590,730,6947,6947,0,0,6947,6878,45,6740,25,31,0,37,69,64,5,0,0,0,6947,106,6841,6947,3079,3868,45,42,101,016700
42,016800,0000000579229,00004553,2040,2040,0,2040,1687,353,4553,4553,0,0,4553,4477,23,4402,15,18,2,17,76,60,15,1,0,0,4553,61,4492,4553,1963,2590,23,42,101,016800
42,016901,0000000513979,00003892,1835,1835,0,1835,1493,342,3892,3892,0,0,3892,3851,29,3792,15,7,2,6,41,40,1,0,0,0,3892,38,3854,3892,1692,2200,29,42,101,016901
42,016902,0000000562208,00006492,3059,3059,0,3059,2441,618,6492,6492,0,0,6492,6415,31,6354,6,11,1,12,77,72,5,0,0,0,6492,51,6441,6492,2839,3653,31,42,101,016902
42,017000,0000001588988,00002840,1411,1411,0,1411,1081,330,2840,2840,0,0,2840,2814,300,2488,9,5,1,11,26,25,0,1,0,0,2840,43,2797,2840,1255,1585,300,42,101,017000
42,017100,0000001150182,00004435,1824,1824,0,1824,1671,153,4435,4435,0,0,4435,4395,35,4312,11,8,0,29,40,35,5,0,0,0,4435,51,4384,4435,1897,2538,35,42,101,017100
42,017200,0000000560531,00008643,3650,3650,0,3650,3161,489,8643,8643,0,0,8643,8591,44,8468,14,26,0,39,52,50,2,0,0,0,8643,106,8537,8643,3707,4936,44,42,101,017200
42,017300,0000000875674,00003152,1427,1427,0,1427,1210,217,3152,3152,0,0,3152,3125,28,3051,5,12,1,28,27,27,0,0,0,0,3152,50,3102,3152,1377,1775,28,42,101,017300
42,017400,0000000347597,00002641,1175,1175,0,1175,867,308,2641,2641,0,0,2641,2613,15,2506,5,8,1,78,28,25,3,0,0,0,2641,90,2551,2641,1144,1497,15,42,101,017400
42,017500,0000000719720,00007452,2736,2736,0,2736,2229,507,7452,7452,0,0,7452,7167,1404,2659,59,38,13,2994,285,277,7,1,0,0,7452,4934,2518,7452,3465,3987,1404,42,101,017500
42,017601,0000000589704,00005863,2240,2240,0,2240,1783,457,5863,5863,0,0,5863,5546,1290,675,63,26,2,3490,317,313,4,0,0,0,5863,5188,675,5863,2799,3064,1290,42,101,017601
42,017602,0000000394381,00003867,1406,1406,0,1406,1118,288,3867,3867,0,0,3867,3672,978,609,30,49,5,2001,195,184,11,0,0,0,3867,2999,868,3867,1834,2033,978,42,101,017602
42,017700,0000000714810,00009159,3355,3355,0,3355,2677,678,9159,9159,0,0,9159,8810,2811,2343,71,336,13,3236,349,336,10,1,2,0,9159,5047,4112,9159,4261,4898,2811,42,101,017700
42,017800,0000000660699,00006340,2642,2642,0,2642,2100,542,6340,6340,0,0,6340,6088,3239,1347,41,224,3,1234,252,248,4,0,0,0,6340,2099,4241,6340,3125,3215,3239,42,101,017800
42,017900,0000000695087,00006050,2503,2503,0,2503,2108,395,6050,6050,0,0,6050,5853,4350,841,16,58,3,585,197,186,9,2,0,0,6050,929,5121,6050,2802,3248,4350,42,101,017900
42,018000,0000000819245,00008005,3753,3753,0,3753,3408,345,8005,8005,0,0,8005,7835,7720,22,15,34,4,40,170,168,0,1,0,1,8005,111,7894,8005,3813,4192,7720,42,101,018000
42,018100,0000000857621,00000215,117,117,0,117,99,18,215,215,0,0,215,209,195,12,0,0,0,2,6,6,0,0,0,0,215,5,210,215,118,97,195,42,101,018100
42,018200,0000002350963,00000393,180,180,0,180,161,19,393,393,0,0,393,380,360,6,0,3,0,11,13,13,0,0,0,0,393,17,376,393,204,189,360,42,101,018200
42,018300,0000001886012,00004008,1707,1707,0,1707,1612,95,4008,4008,0,0,4008,3970,3911,11,16,6,1,25,38,38,0,0,0,0,4008,42,3966,4008,1883,2125,3911,42,101,018300
42,018400,0000001359010,00002178,886,886,0,886,834,52,2178,2178,0,0,2178,2150,2108,2,9,10,0,21,28,28,0,0,0,0,2178,49,2129,2178,1042,1136,2108,42,101,018400
42,018500,0000000660842,00000123,67,67,0,67,59,8,123,123,0,0,123,121,114,2,0,3,0,2,2,2,0,0,0,0,123,4,119,123,63,60,114,42,101,018500
42,018600,0000000712423,00004892,2185,2185,0,2185,2061,124,4892,4892,0,0,4892,4762,4705,13,2,13,9,20,130,130,0,0,0,0,4892,64,4828,4892,2304,2588,4705,42,101,018600
42,018700,0000000805202,00001576,688,688,0,688,608,80,1576,1576,0,0,1576,1546,1368,92,7,18,0,61,30,29,1,0,0,0,1576,118,1458,1576,748,828,1368,42,101,018700
42,018800,0000000668216,00007257,2911,2911,0,2911,2506,405,7257,7257,0,0,7257,7048,4947,903,22,111,8,1057,209,205,4,0,0,0,7257,1583,5674,7257,3510,3747,4947,42,101,018800
42,018900,0000001022195,00001003,378,378,0,378,326,52,1003,1003,0,0,1003,964,619,170,3,29,0,143,39,36,3,0,0,0,1003,249,754,1003,486,517,619,42,101,018900
42,019000,0000000779798,00006869,2448,2448,0,2448,2242,206,6869,6869,0,0,6869,6662,4034,958,31,294,12,1333,207,204,2,1,0,0,6869,2208,4661,6869,3223,3646,4034,42,101,019000
42,019100,0000001468720,00006662,2783,2783,0,2783,2605,178,6662,6662,0,0,6662,6398,4257,460,22,380,2,1277,264,252,12,0,0,0,6662,1964,4698,6662,3113,3549,4257,42,101,019100
42,019200,0000000656129,00007519,2721,2721,0,2721,2262,459,7519,7519,0,0,7519,7171,2984,1626,50,325,1,2185,348,345,3,0,0,0,7519,3607,3912,7519,3480,4039,2984,42,101,019200
42,019300,0000000927257,00000111,42,42,0,42,38,4,111,111,0,0,111,102,56,10,0,2,0,34,9,9,0,0,0,0,111,48,63,111,52,59,56,42,101,019300
42,019400,0000001345798,00000340,119,119,0,119,105,14,340,340,0,0,340,303,107,72,5,24,1,94,37,33,4,0,0,0,340,174,166,340,164,176,107,42,101,019400
42,019500,0000000788873,00008642,3019,3019,0,3019,2577,442,8642,8642,0,0,8642,8233,2411,1183,65,97,4,4473,409,390,18,1,0,0,8642,6841,1801,8642,4052,4590,2411,42,101,019500
42,019600,0000000750372,00002677,918,918,0,918,831,87,2677,2677,0,0,2677,2581,832,640,30,15,1,1063,96,96,0,0,0,0,2677,1870,807,2677,1242,1435,832,42,101,019600
42,019700,0000000855534,00007139,2307,2307,0,2307,2067,240,7139,7139,0,0,7139,6819,1313,2776,40,73,1,2616,320,275,40,5,0,0,7139,4186,2953,7139,3372,3767,1313,42,101,019700
42,019800,0000000541688,00006239,2109,2109,0,2109,1850,259,6239,6239,0,0,6239,5922,863,2529,57,174,13,2286,317,249,22,46,0,0,6239,3444,2795,6239,2934,3305,863,42,101,019800
42,019900,0000000664919,00004897,1701,1701,0,1701,1444,257,4897,4897,0,0,4897,4741,713,2282,35,28,16,1667,156,154,2,0,0,0,4897,2524,2373,4897,2291,2606,713,42,101,019900
42,020000,0000000319461,00001861,783,783,0,783,629,154,1861,1861,0,0,1861,1840,307,1320,6,130,0,77,21,16,5,0,0,0,1861,95,1766,1861,874,987,307,42,101,020000
42,020100,0000000871226,00007732,3843,3843,0,3843,3120,723,7732,7732,0,0,7732,7629,80,7425,20,23,2,79,103,94,9,0,0,0,7732,169,7563,7732,3497,4235,80,42,101,020100
42,020200,0000000763558,00005666,2661,2661,0,2661,2174,487,5666,5666,0,0,5666,5602,140,5391,17,10,1,43,64,55,9,0,0,0,5666,78,5588,5666,2558,3108,140,42,101,020200
42,020300,0000000524368,00003140,1461,1461,0,1461,1081,380,3140,3140,0,0,3140,3085,118,2831,21,30,0,85,55,45,10,0,0,0,3140,148,2992,3140,1435,1705,118,42,101,020300
42,020400,0000000412223,00003398,1395,1395,0,1395,1184,211,3398,3398,0,0,3398,3354,79,3235,3,8,0,29,44,38,6,0,0,0,3398,64,3334,3398,1535,1863,79,42,101,020400
42,020500,0000001431411,00003139,1490,1490,0,1490,1296,194,3139,3139,0,0,3139,3090,181,2765,7,91,0,46,49,49,0,0,0,0,3139,72,3067,3139,1340,1799,181,42,101,020500
42,020600,0000001285681,00001815,1036,1036,0,1036,977,59,1815,1815,0,0,1815,1774,1100,501,2,144,0,27,41,36,4,1,0,0,1815,56,1759,1815,791,1024,1100,42,101,020600
42,020700,0000001429929,00006378,2674,2674,0,2674,2369,305,6378,6378,0,0,6378,6266,5042,972,25,191,3,33,112,105,7,0,0,0,6378,146,6232,6378,2951,3427,5042,42,101,020700
42,020800,0000000896401,00001906,1260,1260,0,1260,1207,53,1906,1906,0,0,1906,1855,1145,536,1,147,0,26,51,38,13,0,0,0,1906,62,1844,1906,866,1040,1145,42,101,020800
42,020900,0000000530703,00002835,1365,1365,0,1365,1300,65,2835,2835,0,0,2835,2799,2695,57,4,29,0,14,36,32,3,1,0,0,2835,41,2794,2835,1399,1436,2695,42,101,020900
42,021000,0000000850881,00004994,2244,2244,0,2244,2131,113,4994,4994,0,0,4994,4937,4630,228,9,48,2,20,57,56,1,0,0,0,4994,63,4931,4994,2391,2603,4630,42,101,021000
42,021100,0000000547341,00002587,1226,1226,0,1226,1160,66,2587,2587,0,0,2587,2561,2302,209,0,38,0,12,26,25,1,0,0,0,2587,52,2535,2587,1211,1376,2302,42,101,021100
42,021200,0000000496204,00002401,1116,1116,0,1116,1070,46,2401,2401,0,0,2401,2374,2179,125,6,45,1,18,27,26,1,0,0,0,2401,53,2348,2401,1130,1271,2179,42,101,021200
42,021300,0000000543516,00003676,1613,1613,0,1613,1527,86,3676,3676,0,0,3676,3633,3331,240,7,34,0,21,43,43,0,0,0,0,3676,61,3615,3676,1780,1896,3331,42,101,021300
42,021400,0000000634669,00003970,1970,1970,0,1970,1824,146,3970,3970,0,0,3970,3909,3426,397,16,55,0,15,61,55,6,0,0,0,3970,57,3913,3970,1998,1972,3426,42,101,021400
42,021500,0000000997612,00003541,1646,1646,0,1646,1524,122,3541,3541,0,0,3541,3503,3297,119,7,65,1,14,38,37,1,0,0,0,3541,46,3495,3541,1731,1810,3297,42,101,021500
42,021600,0000002065693,00001780,892,892,0,892,850,42,1780,1780,0,0,1780,1754,1531,189,3,21,0,10,26,26,0,0,0,0,1780,30,1750,1780,822,958,1531,42,101,021600
42,021700,0000001573304,00005968,2544,2544,0,2544,2471,73,5968,5968,0,0,5968,5888,5341,356,13,154,0,24,80,77,3,0,0,0,5968,102,5866,5968,2808,3160,5341,42,101,021700
42,021800,0000001015446,00004490,2374,2374,0,2374,2317,57,4490,4490,0,0,4490,4388,3636,352,4,351,1,44,102,93,7,2,0,0,4490,143,4347,4490,2088,2402,3636,42,101,021800
42,021900,0000001319379,00001169,543,543,0,543,518,25,1169,1169,0,0,1169,1149,1067,61,0,19,1,1,20,14,5,1,0,0,1169,22,1147,1169,537,632,1067,42,101,021900
42,022000,0000002916680,00001603,733,733,0,733,690,43,1603,1603,0,0,1603,1592,1473,78,2,31,2,6,11,11,0,0,0,0,1603,18,1585,1603,624,979,1473,42,101,022000
42,022100,0000000656600,00001108,471,471,0,471,462,9,1108,1108,0,0,1108,1095,1038,33,1,23,0,0,13,13,0,0,0,0,1108,26,1082,1108,469,639,1038,42,101,022100
42,022200,0000001943506,00001446,518,518,0,518,510,8,1446,1446,0,0,1446,1429,1270,100,1,50,1,7,17,10,7,0,0,0,1446,22,1424,1446,712,734,1270,42,101,022200
42,022300,0000005653647,00000202,90,90,0,90,87,3,202,202,0,0,202,198,133,57,1,2,0,5,4,4,0,0,0,0,202,8,194,202,95,107,133,42,101,022300
42,022400,0000000649022,00000384,126,126,0,126,124,2,384,384,0,0,384,381,320,55,0,5,0,1,3,3,0,0,0,0,384,12,372,384,201,183,320,42,101,022400
42,022500,0000000896447,00000571,80,80,0,80,80,0,571,571,0,0,571,562,460,67,0,10,1,24,9,8,0,1,0,0,571,37,534,571,101,470,460,42,101,022500
42,022600,0000000616550,00000475,102,102,0,102,96,6,475,475,0,0,475,474,402,64,3,2,0,3,1,1,0,0,0,0,475,13,462,475,182,293,402,42,101,022600
42,022700,0000000573772,00001231,576,576,0,576,559,17,1231,1231,0,0,1231,1219,1134,55,3,23,0,4,12,12,0,0,0,0,1231,16,1215,1231,536,695,1134,42,101,022700
42,022800,0000000704419,00001520,833,833,0,833,802,31,1520,1520,0,0,1520,1499,1431,28,0,30,0,10,21,21,0,0,0,0,1520,25,1495,1520,644,876,1431,42,101,022800
42,022900,0000001198678,00000301,114,114,0,114,107,7,301,301,0,0,301,297,278,8,0,11,0,0,4,4,0,0,0,0,301,0,301,301,143,158,278,42,101,022900
42,023000,0000001247846,00000438,247,247,0,247,240,7,438,438,0,0,438,431,401,22,1,3,0,4,7,7,0,0,0,0,438,5,433,438,195,243,401,42,101,023000
42,023100,0000000849906,00001242,551,551,0,551,528,23,1242,1242,0,0,1242,1222,1170,25,0,22,0,5,20,15,0,0,5,0,1242,15,1227,1242,584,658,1170,42,101,023100
42,023200,0000000783267,00000649,343,343,0,343,320,23,649,649,0,0,649,638,449,178,0,5,0,6,11,11,0,0,0,0,649,6,643,649,268,381,449,42,101,023200
42,023300,0000000595877,00003097,1484,1484,0,1484,1397,87,3097,3097,0,0,3097,3011,1495,1375,6,73,6,56,86,61,22,3,0,0,3097,74,3023,3097,1342,1755,1495,42,101,023300
42,023400,0000000809228,00000547,217,217,0,217,214,3,547,547,0,0,547,539,395,127,0,8,0,9,8,8,0,0,0,0,547,8,539,547,256,291,395,42,101,023400
42,023500,0000000794652,00001141,521,521,0,521,487,34,1141,1141,0,0,1141,1129,707,394,0,17,0,11,12,11,1,0,0,0,1141,14,1127,1141,509,632,707,42,101,023500
42,023600,0000000978272,00002659,1167,1167,0,1167,1117,50,2659,2659,0,0,2659,2580,1485,1033,3,29,0,30,79,69,10,0,0,0,2659,50,2609,2659,1139,1520,1485,42,101,023600
42,023700,0000001082214,00005123,2358,2358,0,2358,2139,219,5123,5123,0,0,5123,4943,1331,3479,21,44,7,61,180,151,29,0,0,0,5123,128,4995,5123,2150,2973,1331,42,101,023700
42,023800,0000000788265,00004896,2433,2433,0,2433,2197,236,4896,4896,0,0,4896,4748,1081,3595,11,31,4,26,148,126,18,3,0,1,4896,73,4823,4896,2164,2732,1081,42,101,023800
42,023900,0000000489106,00002015,1327,1327,0,1327,1258,69,2015,2015,0,0,2015,1967,624,1220,5,94,2,22,48,44,3,1,0,0,2015,50,1965,2015,900,1115,624,42,101,023900
42,024000,0000000618282,00004208,2201,2201,0,2201,1926,275,4208,4208,0,0,4208,4108,911,3072,11,72,2,40,100,81,19,0,0,0,4208,91,4117,4208,1941,2267,911,42,101,024000
42,024100,0000000409706,00001436,769,769,0,769,683,86,1436,1436,0,0,1436,1410,195,1181,7,16,0,11,26,23,3,0,0,0,1436,12,1424,1436,646,790,195,42,101,024100
42,024200,0000000533953,00004172,1974,1974,0,1974,1720,254,4172,4172,0,0,4172,4071,464,3519,9,22,3,54,101,93,7,1,0,0,4172,86,4086,4172,1880,2292,464,42,101,024200
42,024300,0000000675671,00004016,1888,1888,0,1888,1622,266,4016,4016,0,0,4016,3914,345,3499,7,36,0,27,102,94,6,2,0,0,4016,70,3946,4016,1827,2189,345,42,101,024300
42,024400,0000000422067,00003491,1372,1372,0,1372,1151,221,3491,3491,0,0,3491,3424,195,3174,16,5,1,33,67,63,2,1,1,0,3491,73,3418,3491,1645,1846,195,42,101,024400
42,024500,0000000802597,00004510,1824,1824,0,1824,1543,281,4510,4510,0,0,4510,4421,223,4141,13,7,4,33,89,77,12,0,0,0,4510,88,4422,4510,1936,2574,223,42,101,024500
42,024600,0000000622346,00002883,1357,1357,0,1357,1140,217,2883,2883,0,0,2883,2831,143,2652,13,3,1,19,52,43,9,0,0,0,2883,33,2850,2883,1274,1609,143,42,101,024600
42,024700,0000000940563,00004866,2083,2083,0,2083,1681,402,4866,4866,0,0,4866,4769,313,4398,17,26,0,15,97,84,13,0,0,0,4866,59,4807,4866,2242,2624,313,42,101,024700
42,024800,0000000325186,00002137,807,807,0,807,706,101,2137,2137,0,0,2137,2098,35,2030,6,14,0,13,39,34,5,0,0,0,2137,17,2120,2137,978,1159,35,42,101,024800
42,024900,0000000326025,00003619,1393,1393,0,1393,1235,158,3619,3619,0,0,3619,3570,51,3501,8,6,0,4,49,41,7,1,0,0,3619,31,3588,3619,1591,2028,51,42,101,024900
42,025000,0000000752319,00001120,326,326,0,326,302,24,1120,1120,0,0,1120,1098,100,973,2,7,5,11,22,17,1,4,0,0,1120,21,1099,1120,483,637,100,42,101,025000
42,025100,0000000527721,00002133,977,977,0,977,902,75,2133,2133,0,0,2133,2087,45,2008,15,8,0,11,46,37,9,0,0,0,2133,29,2104,2133,954,1179,45,42,101,025100
42,025200,0000000944427,00007327,3107,3107,0,3107,2736,371,7327,7327,0,0,7327,7197,448,6641,28,25,0,55,130,124,6,0,0,0,7327,95,7232,7327,3196,4131,448,42,101,025200
42,025300,0000000571803,00004284,1901,1901,0,1901,1693,208,4284,4284,0,0,4284,4182,125,4013,8,8,8,20,102,80,13,9,0,0,4284,71,4213,4284,1915,2369,125,42,101,025300
42,025400,0000000772727,00004303,2023,2023,0,2023,1933,90,4303,4303,0,0,4303,4209,222,3923,20,16,0,28,94,83,9,2,0,0,4303,69,4234,4303,1868,2435,222,42,101,025400
42,025500,0000000777730,00002762,1152,1152,0,1152,1087,65,2762,2762,0,0,2762,2683,630,2015,15,11,4,8,79,57,22,0,0,0,2762,43,2719,2762,1252,1510,630,42,101,025500
42,025600,0000000868771,00002975,1190,1190,0,1190,1146,44,2975,2975,0,0,2975,2895,1368,1440,3,52,2,30,80,70,10,0,0,0,2975,67,2908,2975,1335,1640,1368,42,101,025600
42,025700,0000000743665,00003320,1896,1896,0,1896,1728,168,3320,3320,0,0,3320,3230,1911,1148,12,118,4,37,90,74,13,3,0,0,3320,93,3227,3320,1383,1937,1911,42,101,025700
42,025800,0000000583601,00001707,772,772,0,772,757,15,1707,1707,0,0,1707,1676,71,1597,3,2,0,3,31,26,5,0,0,0,1707,15,1692,1707,752,955,71,42,101,025800
42,025900,0000000546218,00005174,2125,2125,0,2125,2049,76,5174,5174,0,0,5174,5102,124,4942,12,15,1,8,72,61,10,1,0,0,5174,62,5112,5174,2303,2871,124,42,101,025900
42,026000,0000000539180,00003050,1255,1255,0,1255,1208,47,3050,3050,0,0,3050,2980,63,2907,5,5,0,0,70,64,6,0,0,0,3050,32,3018,3050,1327,1723,63,42,101,026000
42,026100,0000000664513,00003237,1460,1460,0,1460,1409,51,3237,3237,0,0,3237,3171,85,3063,5,9,1,8,66,59,6,1,0,0,3237,28,3209,3237,1412,1825,85,42,101,026100
42,026200,0000000554858,00004564,1833,1833,0,1833,1781,52,4564,4564,0,0,4564,4483,57,4404,9,6,0,7,81,63,17,1,0,0,4564,49,4515,4564,1981,2583,57,42,101,026200
42,026301,0000000411356,00004313,1628,1628,0,1628,1562,66,4313,4313,0,0,4313,4241,112,4090,17,5,0,17,72,61,11,0,0,0,4313,45,4268,4313,1886,2427,112,42,101,026301
42,026302,0000000694528,00005754,2168,2168,0,2168,2048,120,5754,5754,0,0,5754,5625,82,5487,13,31,3,9,129,115,14,0,0,0,5754,53,5701,5754,2568,3186,82,42,101,026302
42,026400,0000000795447,00005943,2281,2281,0,2281,2187,94,5943,5943,0,0,5943,5825,77,5682,19,12,6,29,118,109,9,0,0,0,5943,92,5851,5943,2592,3351,77,42,101,026400
42,026500,0000000549955,00004823,1885,1885,0,1885,1744,141,4823,4823,0,0,4823,4747,80,4616,18,11,4,18,76,71,5,0,0,0,4823,50,4773,4823,2116,2707,80,42,101,026500
42,026600,0000000899183,00006975,2645,2645,0,2645,2511,134,6975,6975,0,0,6975,6821,71,6702,16,9,0,23,154,138,16,0,0,0,6975,67,6908,6975,3088,3887,71,42,101,026600
42,026700,0000000643341,00007068,2743,2743,0,2743,2546,197,7068,7068,0,0,7068,6968,99,6817,16,25,0,11,100,82,12,6,0,0,7068,51,7017,7068,3177,3891,99,42,101,026700
42,026800,0000000766940,00004698,2060,2060,0,2060,1839,221,4698,4698,0,0,4698,4573,363,4080,16,77,3,34,125,116,8,0,1,0,4698,70,4628,4698,2106,2592,363,42,101,026800
42,026900,0000000622909,00002359,773,773,0,773,723,50,2359,2359,0,0,2359,2285,719,1318,8,174,1,65,74,63,8,3,0,0,2359,114,2245,2359,1083,1276,719,42,101,026900
42,027000,0000000644183,00002452,980,980,0,980,933,47,2452,2452,0,0,2452,2406,535,1696,1,121,0,53,46,38,7,1,0,0,2452,106,2346,2452,1126,1326,535,42,101,027000
42,027100,0000000375764,00002438,950,950,0,950,917,33,2438,2438,0,0,2438,2362,541,1142,6,517,0,156,76,75,1,0,0,0,2438,246,2192,2438,1143,1295,541,42,101,027100
42,027200,0000000662079,00004567,1925,1925,0,1925,1829,96,4567,4567,0,0,4567,4447,687,3245,6,361,0,148,120,112,7,1,0,0,4567,299,4268,4567,2047,2520,687,42,101,027200
42,027300,0000000958933,00006000,2146,2146,0,2146,2038,108,6000,6000,0,0,6000,5755,1355,2614,14,1310,9,453,245,235,8,2,0,0,6000,919,5081,6000,2827,3173,1355,42,101,027300
42,027400,0000000822871,00010479,3611,3611,0,3611,3327,284,10479,10479,0,0,10479,9974,2388,4490,35,2113,5,943,505,477,19,9,0,0,10479,1840,8639,10479,4959,5520,2388,42,101,027400
42,027500,0000000614546,00004823,1685,1685,0,1685,1572,113,4823,4823,0,0,4823,4633,955,2740,14,664,0,260,190,182,8,0,0,0,4823,519,4304,4823,2272,2551,955,42,101,027500
42,027600,0000000663499,00003932,1781,1781,0,1781,1532,249,3932,3932,0,0,3932,3835,152,3622,12,23,5,21,97,91,6,0,0,0,3932,66,3866,3932,1815,2117,152,42,101,027600
42,027700,0000000551000,00005102,2213,2213,0,2213,2054,159,5102,5102,0,0,5102,5040,87,4838,14,83,1,17,62,52,10,0,0,0,5102,88,5014,5102,2165,2937,87,42,101,027700
42,027800,0000000731851,00004867,2270,2270,0,2270,2034,236,4867,4867,0,0,4867,4790,88,4638,8,22,0,34,77,73,4,0,0,0,4867,94,4773,4867,2215,2652,88,42,101,027800
42,027900,0000001295913,00008350,2792,2792,0,2792,2497,295,8350,8350,0,0,8350,8211,1915,6161,16,72,0,47,139,112,27,0,0,0,8350,152,8198,8350,3730,4620,1915,42,101,027900
42,028000,0000000713305,00004819,1864,1864,0,1864,1715,149,4819,4819,0,0,4819,4765,61,4661,16,13,0,14,54,51,3,0,0,0,4819,59,4760,4819,2141,2678,61,42,101,028000
42,028100,0000000508891,00004012,1465,1465,0,1465,1302,163,4012,4012,0,0,4012,3951,186,3593,14,120,2,36,61,60,0,1,0,0,4012,106,3906,4012,1801,2211,186,42,101,028100
42,028200,0000000860951,00005448,2211,2211,0,2211,1650,561,5448,5448,0,0,5448,5346,777,4173,9,293,1,93,102,90,12,0,0,0,5448,185,5263,5448,2354,3094,777,42,101,028200
42,028300,0000000677857,00007270,2861,2861,0,2861,2426,435,7270,7270,0,0,7270,7072,210,5947,28,729,3,155,198,189,9,0,0,0,7270,266,7004,7270,3373,3897,210,42,101,028300
42,028400,0000000477902,00004409,1507,1507,0,1507,1336,171,4409,4409,0,0,4409,4285,335,3443,10,75,2,420,124,114,10,0,0,0,4409,739,3670,4409,2020,2389,335,42,101,028400
42,028500,0000000283162,00002373,884,884,0,884,770,114,2373,2373,0,0,2373,2276,310,1172,5,391,5,393,97,94,3,0,0,0,2373,678,1695,2373,1079,1294,310,42,101,028500
42,028600,0000000684107,00007337,2411,2411,0,2411,2169,242,7337,7337,0,0,7337,7049,1351,3414,30,881,5,1368,288,281,3,4,0,0,7337,2318,5019,7337,3417,3920,1351,42,101,028600
42,028700,0000000350818,00002489,846,846,0,846,776,70,2489,2489,0,0,2489,2390,638,778,6,30,1,937,99,89,10,0,0,0,2489,1533,956,2489,1199,1290,638,42,101,028700
42,028800,0000000455181,00004373,1457,1457,0,1457,1315,142,4373,4373,0,0,4373,3955,1112,911,22,504,12,1394,418,413,3,2,0,0,4373,2087,2286,4373,2105,2268,1112,42,101,028800
42,028900,0000001388121,00010116,3259,3259,0,3259,3003,256,10116,10116,0,0,10116,9360,2745,2677,55,1016,2,2865,756,739,17,0,0,0,10116,4401,5715,10116,4892,5224,2745,42,101,028900
42,029000,0000000803308,00006217,2123,2123,0,2123,1982,141,6217,6217,0,0,6217,5956,1504,2179,34,1308,1,930,261,256,5,0,0,0,6217,1559,4658,6217,2955,3262,1504,42,101,029000
42,029100,0000001355978,00004371,1645,1645,0,1645,1470,175,4371,4371,0,0,4371,4195,1256,1416,15,1166,0,342,176,170,6,0,0,0,4371,639,3732,4371,2088,2283,1256,42,101,029100
42,029200,0000001715396,00004295,1425,1425,0,1425,1325,100,4295,4295,0,0,4295,3978,1744,1211,17,416,9,581,317,313,3,1,0,0,4295,1149,3146,4295,2070,2225,1744,42,101,029200
42,029300,0000000691757,00003005,1222,1222,0,1222,1051,171,3005,3005,0,0,3005,2886,1876,690,19,51,3,247,119,109,10,0,0,0,3005,559,2446,3005,1445,1560,1876,42,101,029300
42,029400,0000000665592,00003125,1296,1296,0,1296,1054,242,3125,3125,0,0,3125,3002,1231,1323,7,33,5,403,123,111,12,0,0,0,3125,675,2450,3125,1505,1620,1231,42,101,029400
42,029500,0000000635012,00001031,440,440,0,440,400,40,1031,1031,0,0,1031,1024,996,9,0,6,0,13,7,6,1,0,0,0,1031,39,992,1031,481,550,996,42,101,029500
42,029600,0000000236516,00001176,508,508,0,508,448,60,1176,1176,0,0,1176,1160,1056,46,14,11,0,33,16,16,0,0,0,0,1176,105,1071,1176,570,606,1056,42,101,029600
42,029700,0000000735917,00000437,182,182,0,182,165,17,437,437,0,0,437,418,384,24,2,4,0,4,19,19,0,0,0,0,437,20,417,437,220,217,384,42,101,029700
42,029800,0000000649094,00004395,1931,1931,0,1931,1796,135,4395,4395,0,0,4395,4285,3526,443,11,36,8,261,110,105,5,0,0,0,4395,376,4019,4395,2082,2313,3526,42,101,029800
42,029900,0000000598853,00004448,1735,1735,0,1735,1554,181,4448,4448,0,0,4448,4330,2015,1776,9,57,0,473,118,116,2,0,0,0,4448,742,3706,4448,1991,2457,2015,42,101,029900
42,030000,0000000911391,00007150,2978,2978,0,2978,2527,451,7150,7150,0,0,7150,6917,2428,3822,30,159,5,473,233,226,7,0,0,0,7150,737,6413,7150,3322,3828,2428,42,101,030000
42,030100,0000000727289,00006050,2484,2484,0,2484,2201,283,6050,6050,0,0,6050,5826,3112,2191,12,121,1,389,224,211,10,3,0,0,6050,775,5275,6050,2926,3124,3112,42,101,030100
42,030200,0000000895435,00006694,2609,2609,0,2609,2417,192,6694,6694,0,0,6694,6531,4619,1223,16,236,2,435,163,161,2,0,0,0,6694,785,5909,6694,3246,3448,4619,42,101,030200
42,030300,0000000756931,00006887,2631,2631,0,2631,2438,193,6887,6887,0,0,6887,6699,4028,1843,14,216,4,594,188,182,6,0,0,0,6887,1056,5831,6887,3242,3645,4028,42,101,030300
42,030400,0000001323413,00000495,224,224,0,224,190,34,495,495,0,0,495,467,312,103,2,9,0,41,28,28,0,0,0,0,495,101,394,495,239,256,312,42,101,030400
42,030500,0000001073883,00010172,3988,3988,0,3988,3786,202,10172,10172,0,0,10172,9941,6782,2041,21,425,1,671,231,218,9,1,3,0,10172,1431,8741,10172,4745,5427,6782,42,101,030500
42,030600,0000000999709,00006911,2856,2856,0,2856,2703,153,6911,6911,0,0,6911,6781,5931,442,4,181,4,219,130,125,4,0,1,0,6911,417,6494,6911,3096,3815,5931,42,101,030600
42,030700,0000000642278,00003114,1454,1454,0,1454,1366,88,3114,3114,0,0,3114,3062,2649,196,7,124,0,86,52,48,4,0,0,0,3114,191,2923,3114,1438,1676,2649,42,101,030700
42,030800,0000000790033,00004440,1768,1768,0,1768,1713,55,4440,4440,0,0,4440,4375,3863,167,9,219,0,117,65,65,0,0,0,0,4440,198,4242,4440,2084,2356,3863,42,101,030800
42,030900,0000000641103,00003529,1440,1440,0,1440,1385,55,3529,3529,0,0,3529,3398,2269,410,14,382,0,323,131,127,4,0,0,0,3529,514,3015,3529,1692,1837,2269,42,101,030900
42,031000,0000001080206,00005888,2280,2280,0,2280,2201,79,5888,5888,0,0,5888,5777,4748,334,11,468,0,216,111,103,8,0,0,0,5888,460,5428,5888,2846,3042,4748,42,101,031000
42,031100,0000000746030,00008395,3178,3178,0,3178,2983,195,8395,8395,0,0,8395,8103,5794,1045,37,663,15,549,292,267,23,2,0,0,8395,1061,7334,8395,4005,4390,5794,42,101,031100
42,031200,0000000412627,00004171,1677,1677,0,1677,1578,99,4171,4171,0,0,4171,4020,2644,619,2,426,6,323,151,146,4,1,0,0,4171,623,3548,4171,1958,2213,2644,42,101,031200
42,031300,0000000719983,00005866,2358,2358,0,2358,2242,116,5866,5866,0,0,5866,5679,4092,472,11,814,0,290,187,181,6,0,0,0,5866,564,5302,5866,2812,3054,4092,42,101,031300
42,031400,0000001134352,00010298,4119,4119,0,4119,3937,182,10298,10298,0,0,10298,10018,8090,563,5,900,2,458,280,272,8,0,0,0,10298,960,9338,10298,4840,5458,8090,42,101,031400
42,031500,0000001186344,00009455,4048,4048,0,4048,3863,185,9455,9455,0,0,9455,9393,9051,121,5,118,8,90,62,62,0,0,0,0,9455,239,9216,9455,4451,5004,9051,42,101,031500
42,031600,0000000730518,00005452,2270,2270,0,2270,2174,96,5452,5452,0,0,5452,5380,5226,61,6,33,0,54,72,70,2,0,0,0,5452,136,5316,5452,2492,2960,5226,42,101,031600
42,031700,0000000875649,00005470,2355,2355,0,2355,2247,108,5470,5470,0,0,5470,5408,4919,243,13,96,0,137,62,62,0,0,0,0,5470,267,5203,5470,2514,2956,4919,42,101,031700
42,031800,0000000476779,00003512,1509,1509,0,1509,1434,75,3512,3512,0,0,3512,3448,2739,416,9,88,0,196,64,63,1,0,0,0,3512,324,3188,3512,1662,1850,2739,42,101,031800
42,031900,0000000767907,00004618,1857,1857,0,1857,1751,106,4618,4618,0,0,4618,4547,4253,163,1,24,0,106,71,68,3,0,0,0,4618,273,4345,4618,2228,2390,4253,42,101,031900
42,032000,0000000691619,00006199,2635,2635,0,2635,2530,105,6199,6199,0,0,6199,6127,5856,102,2,52,6,109,72,71,1,0,0,0,6199,211,5988,6199,2967,3232,5856,42,101,032000
42,032100,0000000552230,00003741,1579,1579,0,1579,1407,172,3741,3741,0,0,3741,3664,3365,184,9,32,0,74,77,68,9,0,0,0,3741,152,3589,3741,1832,1909,3365,42,101,032100
42,032200,0000000534762,00000197,71,71,0,71,58,13,197,197,0,0,197,195,145,36,6,2,0,6,2,2,0,0,0,0,197,21,176,197,100,97,145,42,101,032200
42,032300,0000000606992,00003596,1555,1555,0,1555,1457,98,3596,3596,0,0,3596,3538,3268,151,15,37,1,66,58,56,2,0,0,0,3596,144,3452,3596,1695,1901,3268,42,101,032300
42,032400,0000000679439,00000018,10,10,0,10,5,5,18,18,0,0,18,18,18,0,0,0,0,0,0,0,0,0,0,0,18,0,18,18,8,10,18,42,101,032400
42,032500,0000000836355,00005285,2434,2434,0,2434,2192,242,5285,5285,0,0,5285,5222,4953,128,7,52,1,81,63,53,9,1,0,0,5285,165,5120,5285,2528,2757,4953,42,101,032500
42,032600,0000000807103,00006561,2706,2706,0,2706,2570,136,6561,6561,0,0,6561,6481,6169,174,5,73,1,59,80,76,4,0,0,0,6561,180,6381,6561,3129,3432,6169,42,101,032600
42,032700,0000001378432,00000494,74,74,0,74,66,8,494,494,0,0,494,480,187,270,3,6,2,12,14,10,4,0,0,0,494,24,470,494,291,203,187,42,101,032700
42,032800,0000002679847,00006206,1,1,0,1,1,0,6206,6206,0,0,6206,6178,916,4533,2,36,4,687,28,28,0,0,0,0,6206,769,5437,6206,5616,590,916,42,101,032800
42,032900,0000000940623,00004073,1825,1825,0,1825,1685,140,4073,4073,0,0,4073,3994,3325,574,7,37,3,48,79,75,4,0,0,0,4073,198,3875,4073,1917,2156,3325,42,101,032900
42,033000,0000000739982,00007169,2878,2878,0,2878,2726,152,7169,7169,0,0,7169,7096,6731,188,18,66,3,90,73,68,5,0,0,0,7169,253,6916,7169,3405,3764,6731,42,101,033000
42,033100,0000001191824,00008896,3864,3864,0,3864,3660,204,8896,8896,0,0,8896,8801,8464,162,17,103,0,55,95,93,2,0,0,0,8896,207,8689,8896,4156,4740,8464,42,101,033100
42,033200,0000000837386,00002542,1034,1034,0,1034,995,39,2542,2542,0,0,2542,2523,2438,43,6,27,0,9,19,19,0,0,0,0,2542,53,2489,2542,1186,1356,2438,42,101,033200
42,033300,0000001045351,00004272,1836,1836,0,1836,1768,68,4272,4272,0,0,4272,4207,3744,277,5,123,0,58,65,62,3,0,0,0,4272,145,4127,4272,1742,2530,3744,42,101,033300
42,033400,0000001177869,00004795,2113,2113,0,2113,2033,80,4795,4795,0,0,4795,4688,3925,328,12,316,0,107,107,102,4,1,0,0,4795,312,4483,4795,2144,2651,3925,42,101,033400
42,033500,0000000919831,00003453,1564,1564,0,1564,1511,53,3453,3453,0,0,3453,3412,2990,117,6,243,0,56,41,41,0,0,0,0,3453,162,3291,3453,1617,1836,2990,42,101,033500
42,033600,0000001132659,00006364,2866,2866,0,2866,2734,132,6364,6364,0,0,6364,6280,5801,137,7,201,0,134,84,79,4,1,0,0,6364,267,6097,6364,3003,3361,5801,42,101,033600
42,033700,0000002038707,00009328,4373,4373,0,4373,4208,165,9328,9328,0,0,9328,9185,8487,168,5,326,2,197,143,134,7,2,0,0,9328,425,8903,9328,4297,5031,8487,42,101,033700
42,033800,0000001391172,00005981,2633,2633,0,2633,2544,89,5981,5981,0,0,5981,5924,5562,131,6,88,4,133,57,57,0,0,0,0,5981,257,5724,5981,2843,3138,5562,42,101,033800
42,033900,0000001137871,00002749,1286,1286,0,1286,1221,65,2749,2749,0,0,2749,2708,2532,48,6,87,0,35,41,41,0,0,0,0,2749,93,2656,2749,1324,1425,2532,42,101,033900
42,034000,0000000756688,00002495,1020,1020,0,1020,993,27,2495,2495,0,0,2495,2489,2392,18,1,48,1,29,6,6,0,0,0,0,2495,72,2423,2495,1174,1321,2392,42,101,034000
42,034100,0000001351713,00005627,2628,2628,0,2628,2505,123,5627,5627,0,0,5627,5553,5145,132,4,222,1,49,74,72,2,0,0,0,5627,123,5504,5627,2563,3064,5145,42,101,034100
42,034200,0000000991519,00003180,1449,1449,0,1449,1408,41,3180,3180,0,0,3180,3151,2841,170,3,113,0,24,29,28,1,0,0,0,3180,75,3105,3180,1388,1792,2841,42,101,034200
42,034300,0000005404820,00000195,73,73,0,73,68,5,195,195,0,0,195,195,188,3,0,3,0,1,0,0,0,0,0,0,195,5,190,195,96,99,188,42,101,034300
42,034400,0000003452579,00007291,2762,2762,0,2762,2713,49,7291,7291,0,0,7291,7223,6603,65,6,492,0,57,68,66,2,0,0,0,7291,177,7114,7291,3441,3850,6603,42,101,034400
42,034500,0000001437725,00008440,4378,4378,0,4378,4218,160,8440,8440,0,0,8440,8301,6756,605,11,784,3,142,139,134,4,1,0,0,8440,398,8042,8440,3723,4717,6756,42,101,034500
42,034600,0000001835045,00001871,1125,1125,0,1125,1085,40,1871,1871,0,0,1871,1837,1277,429,4,89,1,37,34,33,1,0,0,0,1871,141,1730,1871,840,1031,1277,42,101,034600
42,034701,0000001143078,00006083,2537,2537,0,2537,2460,77,6083,6083,0,0,6083,5965,4981,306,19,547,6,106,118,112,6,0,0,0,6083,304,5779,6083,2900,3183,4981,42,101,034701
42,034702,0000001006967,00004052,1491,1491,0,1491,1447,44,4052,4052,0,0,4052,4007,3646,174,10,148,0,29,45,43,2,0,0,0,4052,112,3940,4052,1826,2226,3646,42,101,034702
42,034801,0000001398175,00004286,1952,1952,0,1952,1899,53,4286,4286,0,0,4286,4257,4035,166,7,17,1,31,29,24,5,0,0,0,4286,88,4198,4286,2019,2267,4035,42,101,034801
42,034802,0000001218190,00005458,2299,2299,0,2299,2218,81,5458,5458,0,0,5458,5374,4242,810,15,166,4,137,84,79,5,0,0,0,5458,345,5113,5458,2596,2862,4242,42,101,034802
42,034803,0000001299310,00004495,1865,1865,0,1865,1786,79,4495,4495,0,0,4495,4441,4115,204,4,65,0,53,54,54,0,0,0,0,4495,142,4353,4495,2150,2345,4115,42,101,034803
42,034900,0000001957640,00006589,2775,2775,0,2775,2572,203,6589,6589,0,0,6589,6437,4648,1459,14,154,2,160,152,146,3,2,1,0,6589,424,6165,6589,3030,3559,4648,42,101,034900
42,035100,0000000984273,00004637,2614,2614,0,2614,2499,115,4637,4637,0,0,4637,4594,4272,204,3,81,0,34,43,40,3,0,0,0,4637,112,4525,4637,1994,2643,4272,42,101,035100
42,035200,0000001867699,00004370,1773,1773,0,1773,1716,57,4370,4370,0,0,4370,4319,4088,27,9,168,0,27,51,49,2,0,0,0,4370,63,4307,4370,2092,2278,4088,42,101,035200
42,035301,0000001519902,00005495,2051,2051,0,2051,1995,56,5495,5495,0,0,5495,5438,5070,163,12,149,1,43,57,57,0,0,0,0,5495,131,5364,5495,2678,2817,5070,42,101,035301
42,035302,0000001539691,00004479,1989,1989,0,1989,1936,53,4479,4479,0,0,4479,4429,4017,263,9,94,1,45,50,46,3,0,1,0,4479,111,4368,4479,2112,2367,4017,42,101,035302
42,035400,0000007649397,00000008,0,0,0,0,0,0,8,8,0,0,8,8,5,3,0,0,0,0,0,0,0,0,0,0,8,0,8,8,2,6,5,42,101,035400
42,035500,0000002327364,00006793,3020,3020,0,3020,2909,111,6793,6793,0,0,6793,6693,6137,166,4,321,3,62,100,99,1,0,0,0,6793,212,6581,6793,3188,3605,6137,42,101,035500
42,035600,0000003439768,00008789,3686,3686,0,3686,3599,87,8789,8789,0,0,8789,8704,7761,255,20,601,1,66,85,84,1,0,0,0,8789,232,8557,8789,4024,4765,7761,42,101,035600
42,035700,0000002146073,00009027,3815,3815,0,3815,3651,164,9027,9027,0,0,9027,8794,6913,354,25,1350,2,150,233,220,13,0,0,0,9027,372,8655,9027,4334,4693,6913,42,101,035700
42,035800,0000001758885,00005951,2359,2359,0,2359,2323,36,5951,5951,0,0,5951,5858,5235,189,5,389,4,36,93,92,1,0,0,0,5951,163,5788,5951,2854,3097,5235,42,101,035800
42,035900,0000002259042,00005453,2229,2229,0,2229,2191,38,5453,5453,0,0,5453,5369,4729,127,13,442,2,56,84,80,4,0,0,0,5453,159,5294,5453,2530,2923,4729,42,101,035900
42,036000,0000002045095,00002947,1017,1017,0,1017,994,23,2947,2947,0,0,2947,2878,2364,155,0,318,0,41,69,61,8,0,0,0,2947,77,2870,2947,1288,1659,2364,42,101,036000
42,036100,0000001216915,00003976,1620,1620,0,1620,1506,114,3976,3976,0,0,3976,3913,3252,476,9,94,5,77,63,52,11,0,0,0,3976,219,3757,3976,1946,2030,3252,42,101,036100
42,036201,0000001049187,00005063,2119,2119,0,2119,2072,47,5063,5063,0,0,5063,4992,4642,192,7,110,2,39,71,67,4,0,0,0,5063,135,4928,5063,2424,2639,4642,42,101,036201
42,036202,0000001139783,00006334,2367,2367,0,2367,2315,52,6334,6334,0,0,6334,6247,5625,485,4,78,2,53,87,85,2,0,0,0,6334,155,6179,6334,3033,3301,5625,42,101,036202
42,036203,0000001470662,00005279,1918,1918,0,1918,1867,51,5279,5279,0,0,5279,5230,4959,106,10,107,0,48,49,49,0,0,0,0,5279,136,5143,5279,2560,2719,4959,42,101,036203
42,036301,0000002398297,00003866,1402,1402,0,1402,1353,49,3866,3866,0,0,3866,3817,3458,76,2,210,3,68,49,49,0,0,0,0,3866,141,3725,3866,1888,1978,3458,42,101,036301
42,036302,0000000518680,00003789,1344,1344,0,1344,1284,60,3789,3789,0,0,3789,3735,2995,527,7,121,0,85,54,49,5,0,0,0,3789,199,3590,3789,1892,1897,2995,42,101,036302
42,036303,0000002493805,00007123,2485,2485,0,2485,2459,26,7123,7123,0,0,7123,7057,6832,74,9,92,1,49,66,62,4,0,0,0,7123,137,6986,7123,3461,3662,6832,42,101,036303
42,036400,0000004612211,00000304,18,18,0,18,14,4,304,304,0,0,304,296,198,85,1,0,1,11,8,8,0,0,0,0,304,30,274,304,235,69,198,42,101,036400
42,036500,0000003596082,00009474,3745,3745,0,3745,3627,118,9474,9474,0,0,9474,9367,8542,455,13,271,3,83,107,101,6,0,0,0,9474,273,9201,9474,4514,4960,8542,42,101,036500
42,036600,0000001018874,00000644,383,383,0,383,373,10,644,644,0,0,644,634,562,50,1,19,0,2,10,10,0,0,0,0,644,16,628,644,343,301,562,42,101,036600
42,950100,0000196258271,00006830,5163,5163,0,5163,2712,2451,6830,6830,0,0,6830,6757,6620,26,15,57,0,39,73,67,5,0,1,0,6830,212,6618,6830,3264,3566,6620,42,103,950100
42,950200,0000203465831,00004154,3750,3750,0,3750,1694,2056,4154,4154,0,0,4154,4094,3941,107,8,18,0,20,60,53,7,0,0,0,4154,113,4041,4154,2085,2069,3941,42,103,950200
42,950300,0000089151501,00003145,3838,3838,0,3838,1330,2508,3145,3145,0,0,3145,3118,3081,17,3,6,0,11,27,26,1,0,0,0,3145,50,3095,3145,1611,1534,3081,42,103,950300
42,950500,0000194982236,00003621,3273,3273,0,3273,1382,1891,3621,3621,0,0,3621,3585,3345,122,7,26,1,84,36,35,1,0,0,0,3621,151,3470,3621,1894,1727,3345,42,103,950500
42,950600,0000184209071,00011184,6843,6843,0,6843,4029,2814,11184,11184,0,0,11184,11026,10587,233,47,60,0,99,158,140,18,0,0,0,11184,511,10673,11184,5570,5614,10587,42,103,950600
42,950700,0000114003176,00006319,3453,3453,0,3453,2244,1209,6319,6319,0,0,6319,6243,6016,136,9,28,0,54,76,74,2,0,0,0,6319,302,6017,6319,3136,3183,6016,42,103,950700
42,950800,0000126600829,00007515,4655,4655,0,4655,2603,2052,7515,7515,0,0,7515,7308,6087,856,16,78,1,270,207,193,14,0,0,0,7515,881,6634,7515,3738,3777,6087,42,103,950800
42,950900,0000307556928,00003534,3706,3706,0,3706,1439,2267,3534,3534,0,0,3534,3492,3432,16,6,12,1,25,42,40,2,0,0,0,3534,95,3439,3534,1776,1758,3432,42,103,950900
42,950100,0000695853387,00004799,2751,2751,0,2751,1779,972,4799,4799,0,0,4799,4769,4728,13,18,3,1,6,30,29,1,0,0,0,4799,25,4774,4799,2417,2382,4728,42,105,950100
42,950200,0000408375654,00003437,1914,1914,0,1914,1327,587,3437,3437,0,0,3437,3403,3383,3,5,5,2,5,34,34,0,0,0,0,3437,18,3419,3437,1703,1734,3383,42,105,950200
42,950300,0000182557768,00004366,2182,2182,0,2182,1705,477,4366,4366,0,0,4366,4338,4242,18,6,60,2,10,28,27,1,0,0,0,4366,24,4342,4366,2139,2227,4242,42,105,950300
42,950400,0000879825301,00003169,2978,2978,0,2978,1274,1704,3169,3169,0,0,3169,3148,3117,5,6,10,0,10,21,21,0,0,0,0,3169,25,3144,3169,1552,1617,3117,42,105,950400
42,950500,0000633592906,00002309,2334,2334,0,2334,920,1414,2309,2309,0,0,2309,2293,2259,13,5,12,0,4,16,16,0,0,0,0,2309,11,2298,2309,1109,1200,2259,42,105,950500
42,000100,0000177428657,00004778,2267,2267,0,2267,1982,285,4778,4778,0,0,4778,4766,4727,6,2,12,0,19,12,12,0,0,0,0,4778,36,4742,4778,2375,2403,4727,42,107,000100
42,000200,0000000851512,00002274,1211,1211,0,1211,1034,177,2274,2274,0,0,2274,2273,2262,2,1,1,0,7,1,1,0,0,0,0,2274,15,2259,2274,1084,1190,2262,42,107,000200
42,000300,0000112002756,00006035,2525,2525,0,2525,2320,205,6035,6035,0,0,6035,6010,5878,93,1,26,1,11,25,22,3,0,0,0,6035,46,5989,6035,2876,3159,5878,42,107,000300
42,000400,0000100345517,00002563,1103,1103,0,1103,991,112,2563,2563,0,0,2563,2561,2555,2,2,1,0,1,2,2,0,0,0,0,2563,13,2550,2563,1307,1256,2555,42,107,000400
42,000500,0000001328323,00004647,2595,2595,0,2595,2113,482,4647,4647,0,0,4647,4625,4591,10,4,10,0,10,22,21,1,0,0,0,4647,60,4587,4647,2192,2455,4591,42,107,000500
42,000600,0000003925410,00005624,3339,3339,0,3339,2649,690,5624,5624,0,0,5624,5590,5478,19,14,20,2,57,34,34,0,0,0,0,5624,155,5469,5624,2569,3055,5478,42,107,000600
42,000700,0000030636296,00007033,1977,1977,0,1977,1692,285,7033,7033,0,0,7033,7021,5133,1665,8,39,0,176,12,12,0,0,0,0,7033,320,6713,7033,4956,2077,5133,42,107,000700
42,000800,0000001545172,00004361,2094,2094,0,2094,1914,180,4361,4361,0,0,4361,4356,4280,16,3,46,0,11,5,5,0,0,0,0,4361,31,4330,4361,2047,2314,4280,42,107,000800
42,000900,0000070610704,00006111,2766,2766,0,2766,2495,271,6111,6111,0,0,6111,6096,6052,21,6,10,0,7,15,13,2,0,0,0,6111,11,6100,6111,2976,3135,6052,42,107,000900
42,001000,0000004473309,00003283,1724,1724,0,1724,1437,287,3283,3283,0,0,3283,3275,3263,7,0,3,0,2,8,8,0,0,0,0,3283,3,3280,3283,1590,1693,3263,42,107,001000
42,001100,0000139123152,00002338,1016,1016,0,1016,883,133,2338,2338,0,0,2338,2338,2333,1,0,4,0,0,0,0,0,0,0,0,2338,7,2331,2338,1152,1186,2333,42,107,001100
42,001200,0000116798374,00004408,1909,1909,0,1909,1792,117,4408,4408,0,0,4408,4397,4366,5,0,9,4,13,11,9,2,0,0,0,4408,30,4378,4408,2208,2200,4366,42,107,001200
42,001300,0000101770486,00004126,1406,1406,0,1406,1288,118,4126,4126,0,0,4126,4106,3576,493,4,25,1,7,20,19,1,0,0,0,4126,204,3922,4126,2416,1710,3576,42,107,001300
42,001400,0000067789716,00002778,1050,1050,0,1050,959,91,2778,2778,0,0,2778,2772,2517,244,0,8,0,3,6,6,0,0,0,0,2778,101,2677,2778,1649,1129,2517,42,107,001400
42,001500,0000001696617,00004552,2312,2312,0,2312,2041,271,4552,4552,0,0,4552,4519,4484,20,3,8,1,3,33,29,4,0,0,0,4552,26,4526,4552,2102,2450,4484,42,107,001500
42,001600,0000045086542,00004019,1671,1671,0,1671,1587,84,4019,4019,0,0,4019,4014,3982,5,6,17,0,4,5,5,0,0,0,0,4019,17,4002,4019,1996,2023,3982,42,107,001600
42,001700,0000005761695,00003544,1498,1498,0,1498,1380,118,3544,3544,0,0,3544,3524,3430,26,2,44,0,22,20,16,4,0,0,0,3544,43,3501,3544,1700,1844,3430,42,107,001700
42,001800,0000001157672,00002296,1108,1108,0,1108,1026,82,2296,2296,0,0,2296,2286,2236,38,3,3,0,6,10,10,0,0,0,0,2296,23,2273,2296,1007,1289,2236,42,107,001800
42,001900,0000001486914,00005894,3102,3102,0,3102,2555,547,5894,5894,0,0,5894,5817,5523,218,9,25,1,41,77,72,5,0,0,0,5894,99,5795,5894,2852,3042,5523,42,107,001900
42,002000,0000002485664,00003815,1635,1635,0,1635,1438,197,3815,3815,0,0,3815,3791,3696,70,5,7,0,13,24,21,3,0,0,0,3815,25,3790,3815,1688,2127,3696,42,107,002000
42,002100,0000003590915,00001567,708,708,0,708,653,55,1567,1567,0,0,1567,1552,1546,2,0,4,0,0,15,15,0,0,0,0,1567,4,1563,1567,742,825,1546,42,107,002100
42,002200,0000012517978,00002883,1310,1310,0,1310,1212,98,2883,2883,0,0,2883,2878,2858,14,1,1,1,3,5,5,0,0,0,0,2883,13,2870,2883,1375,1508,2858,42,107,002200
42,002300,0000003166302,00003254,1647,1647,0,1647,1497,150,3254,3254,0,0,3254,3246,3212,22,3,2,0,7,8,7,1,0,0,0,3254,23,3231,3254,1527,1727,3212,42,107,002300
42,002400,0000076291077,00002512,1251,1251,0,1251,1089,162,2512,2512,0,0,2512,2508,2497,0,1,9,0,1,4,4,0,0,0,0,2512,8,2504,2512,1248,1264,2497,42,107,002400
42,002500,0000084589371,00002059,951,951,0,951,864,87,2059,2059,0,0,2059,2054,2047,1,3,3,0,0,5,5,0,0,0,0,2059,3,2056,2059,1013,1046,2047,42,107,002500
42,002600,0000008558252,00004142,2129,2129,0,2129,1890,239,4142,4142,0,0,4142,4109,4090,3,1,9,0,6,33,30,3,0,0,0,4142,67,4075,4142,1986,2156,4090,42,107,002600
42,002700,0000016898896,00003032,1473,1473,0,1473,1289,184,3032,3032,0,0,3032,3024,2990,10,5,7,0,12,8,7,1,0,0,0,3032,26,3006,3032,1452,1580,2990,42,107,002700
42,002800,0000005633211,00002295,1209,1209,0,1209,1046,163,2295,2295,0,0,2295,2284,2257,7,1,6,0,13,11,11,0,0,0,0,2295,26,2269,2295,1071,1224,2257,42,107,002800
42,002900,0000197868998,00004702,1990,1990,0,1990,1822,168,4702,4702,0,0,4702,4682,4647,9,4,9,0,13,20,14,6,0,0,0,4702,34,4668,4702,2383,2319,4647,42,107,002900
42,003000,0000114795756,00005291,2183,2183,0,2183,2057,126,5291,5291,0,0,5291,5252,5145,8,4,90,0,5,39,37,1,1,0,0,5291,22,5269,5291,2636,2655,5145,42,107,003000
42,003100,0000005667771,00003106,1217,1217,0,1217,1158,59,3106,3106,0,0,3106,3089,3035,10,1,34,2,7,17,17,0,0,0,0,3106,17,3089,3106,1399,1707,3035,42,107,003100
42,003200,0000056106943,00005033,2109,2109,0,2109,1968,141,5033,5033,0,0,5033,5014,4951,19,6,33,2,3,19,18,1,0,0,0,5033,19,5014,5033,2508,2525,4951,42,107,003200
42,003300,0000003676667,00005548,2551,2551,0,2551,2393,158,5548,5548,0,0,5548,5502,5394,42,8,39,3,16,46,45,1,0,0,0,5548,70,5478,5548,2645,2903,5394,42,107,003300
42,003400,0000059371395,00003200,1378,1378,0,1378,1187,191,3200,3200,0,0,3200,3184,3153,17,0,6,0,8,16,16,0,0,0,0,3200,15,3185,3200,1582,1618,3153,42,107,003400
42,003500,0000090741467,00004721,1972,1972,0,1972,1827,145,4721,4721,0,0,4721,4708,4661,11,2,23,0,11,13,10,3,0,0,0,4721,19,4702,4721,2350,2371,4661,42,107,003500
42,003600,0000080389113,00002750,1082,1082,0,1082,1001,81,2750,2750,0,0,2750,2741,2725,5,0,8,1,2,9,9,0,0,0,0,2750,5,2745,2750,1408,1342,2725,42,107,003600
42,003700,0000108058672,00003678,1705,1705,0,1705,1554,151,3678,3678,0,0,3678,3666,3653,3,0,3,0,7,12,10,2,0,0,0,3678,21,3657,3678,1788,1890,3653,42,107,003700
42,003800,0000002793595,00002154,937,937,0,937,877,60,2154,2154,0,0,2154,2143,2127,3,0,11,0,2,11,10,1,0,0,0,2154,1,2153,2154,1016,1138,2127,42,107,003800
42,003900,0000098925096,00003930,1696,1696,0,1696,1570,126,3930,3930,0,0,3930,3912,3899,0,1,10,0,2,18,18,0,0,0,0,3930,13,3917,3930,1947,1983,3899,42,107,003900
42,980100,0000045223423,00005514,2498,2498,0,2498,2321,177,5514,5514,0,0,5514,5481,5391,19,4,55,0,12,33,28,3,0,2,0,5514,34,5480,5514,2659,2855,5391,42,109,980100
42,980200,0000122452009,00007028,2548,2548,0,2548,2354,194,7028,7028,0,0,7028,7000,6821,109,2,35,0,33,28,28,0,0,0,0,7028,102,6926,7028,3617,3411,6821,42,109,980200
42,980300,0000131154693,00005638,2335,2335,0,2335,2178,157,5638,5638,0,0,5638,5622,5585,18,7,4,1,7,16,14,2,0,0,0,5638,25,5613,5638,2748,2890,5585,42,109,980300
42,980400,0000240118511,00005260,2178,2178,0,2178,1938,240,5260,5260,0,0,5260,5236,5223,5,0,3,0,5,24,24,0,0,0,0,5260,18,5242,5260,2622,2638,5223,42,109,980400
42,980500,0000177612731,00003662,1604,1604,0,1604,1382,222,3662,3662,0,0,3662,3639,3631,4,0,4,0,0,23,23,0,0,0,0,3662,9,3653,3662,1783,1879,3631,42,109,980500
42,980600,0000136257648,00005061,1815,1815,0,1815,1714,101,5061,5061,0,0,5061,5043,5021,5,1,6,1,9,18,18,0,0,0,0,5061,23,5038,5061,2566,2495,5021,42,109,980600
42,980700,0000004996500,00005383,1912,1912,0,1912,1767,145,5383,5383,0,0,5383,5343,5096,147,4,49,0,47,40,32,8,0,0,0,5383,157,5226,5383,2357,3026,5096,42,109,980700
42,020101,0000053333435,00002134,873,873,0,873,833,40,2134,2134,0,0,2134,2130,2129,1,0,0,0,0,4,4,0,0,0,0,2134,3,2131,2134,1048,1086,2129,42,111,020101
42,020102,0000054505479,00005512,2299,2299,0,2299,2193,106,5512,5512,0,0,5512,5503,5482,2,5,9,1,4,9,9,0,0,0,0,5512,28,5484,5512,2616,2896,5482,42,111,020102
42,020200,0000177502744,00004991,2069,2069,0,2069,1937,132,4991,4991,0,0,4991,4975,4961,6,0,5,0,3,16,16,0,0,0,0,4991,22,4969,4991,2412,2579,4961,42,111,020200
42,020300,0000005372463,00004395,2177,2177,0,2177,2019,158,4395,4395,0,0,4395,4379,4364,0,3,4,1,7,16,16,0,0,0,0,4395,25,4370,4395,2025,2370,4364,42,111,020300
42,020400,0000175940569,00004176,1893,1893,0,1893,1724,169,4176,4176,0,0,4176,4157,4149,3,1,3,0,1,19,19,0,0,0,0,4176,16,4160,4176,2075,2101,4149,42,111,020400
42,020500,0000093581875,00003355,1440,1440,0,1440,1331,109,3355,3355,0,0,3355,3345,3336,3,4,1,0,1,10,10,0,0,0,0,3355,10,3345,3355,1642,1713,3336,42,111,020500
42,020600,0000174216504,00006132,2797,2797,0,2797,2508,289,6132,6132,0,0,6132,6112,6095,2,5,5,0,5,20,20,0,0,0,0,6132,11,6121,6132,3003,3129,6095,42,111,020600
42,020700,0000173699580,00003044,1899,1899,0,1899,1174,725,3044,3044,0,0,3044,3039,3024,7,1,3,0,4,5,5,0,0,0,0,3044,10,3034,3044,1570,1474,3024,42,111,020700
42,020800,0000078966527,00004095,1690,1690,0,1690,1587,103,4095,4095,0,0,4095,4074,4026,3,3,38,0,4,21,21,0,0,0,0,4095,11,4084,4095,1981,2114,4026,42,111,020800
42,020900,0000086564227,00005224,2009,2009,0,2009,1897,112,5224,5224,0,0,5224,5210,5032,135,3,12,0,28,14,13,1,0,0,0,5224,35,5189,5224,2779,2445,5032,42,111,020900
42,021000,0000004206435,00004356,1996,1996,0,1996,1866,130,4356,4356,0,0,4356,4339,4266,22,3,34,2,12,17,17,0,0,0,0,4356,25,4331,4356,1921,2435,4266,42,111,021000
42,021100,0000002895463,00002406,1317,1317,0,1317,1169,148,2406,2406,0,0,2406,2389,2347,25,3,13,0,1,17,16,1,0,0,0,2406,12,2394,2406,1130,1276,2347,42,111,021100
42,021200,0000168431083,00002916,1681,1681,0,1681,1122,559,2916,2916,0,0,2916,2904,2890,2,7,3,0,2,12,10,0,2,0,0,2916,7,2909,2916,1466,1450,2890,42,111,021200
42,021300,0000462050034,00003515,1794,1794,0,1794,1320,474,3515,3515,0,0,3515,3492,3458,7,5,9,0,13,23,22,1,0,0,0,3515,14,3501,3515,1794,1721,3458,42,111,021300
42,021400,0000164704182,00006376,1857,1857,0,1857,1743,114,6376,6376,0,0,6376,6310,5090,1034,6,21,0,159,66,65,1,0,0,0,6376,239,6137,6376,3983,2393,5090,42,111,021400
42,021500,0000118621627,00002817,1110,1110,0,1110,1032,78,2817,2817,0,0,2817,2802,2794,5,2,1,0,0,15,15,0,0,0,0,2817,1,2816,2817,1409,1408,2794,42,111,021500
42,021600,0000002170700,00002473,1089,1089,0,1089,1019,70,2473,2473,0,0,2473,2470,2457,6,3,4,0,0,3,3,0,0,0,0,2473,18,2455,2473,1134,1339,2457,42,111,021600
42,021700,0000148480656,00003171,1287,1287,0,1287,1152,135,3171,3171,0,0,3171,3160,3154,0,0,0,2,4,11,11,0,0,0,0,3171,22,3149,3171,1548,1623,3154,42,111,021700
42,021800,0000186082725,00003771,1607,1607,0,1607,1493,114,3771,3771,0,0,3771,3766,3752,9,2,3,0,0,5,5,0,0,0,0,3771,5,3766,3771,1857,1914,3752,42,111,021800
42,021900,0000452027159,00005164,4279,4279,0,4279,2103,2176,5164,5164,0,0,5164,5150,5132,3,9,4,0,2,14,14,0,0,0,0,5164,18,5146,5164,2574,2590,5132,42,111,021900
42,980100,0000443302844,00003691,2845,2845,0,2845,1473,1372,3691,3691,0,0,3691,3653,3454,137,31,3,0,28,38,36,2,0,0,0,3691,63,3628,3691,1876,1815,3454,42,113,980100
42,980200,0000722024962,00002865,3172,3172,0,3172,1187,1985,2865,2865,0,0,2865,2847,2812,7,19,7,0,2,18,18,0,0,0,0,2865,9,2856,2865,1436,1429,2812,42,113,980200
42,032000,0000273115067,00003219,1675,1675,0,1675,1236,439,3219,3219,0,0,3219,3192,3176,2,5,4,1,4,27,24,3,0,0,0,3219,30,3189,3219,1650,1569,3176,42,115,032000
42,032100,0000223394565,00003933,2098,2098,0,2098,1462,636,3933,3933,0,0,3933,3897,3867,9,10,3,1,7,36,36,0,0,0,0,3933,20,3913,3933,1964,1969,3867,42,115,032100
42,032200,0000095786767,00003806,1747,1747,0,1747,1600,147,3806,3806,0,0,3806,3788,3744,12,9,15,0,8,18,16,2,0,0,0,3806,17,3789,3806,1864,1942,3744,42,115,032200
42,032300,0000133406904,00004008,1875,1875,0,1875,1538,337,4008,4008,0,0,4008,3989,3943,3,4,35,2,2,19,19,0,0,0,0,4008,45,3963,4008,1938,2070,3943,42,115,032300
42,032400,0000326380961,00004154,2935,2935,0,2935,1650,1285,4154,4154,0,0,4154,4120,4081,13,8,10,0,8,34,34,0,0,0,0,4154,46,4108,4154,2106,2048,4081,42,115,032400
42,032500,0000203089982,00004038,2276,2276,0,2276,1584,692,4038,4038,0,0,4038,4020,3975,21,9,6,0,9,18,18,0,0,0,0,4038,30,4008,4038,2028,2010,3975,42,115,032500
42,032600,0000108302634,00004332,2079,2079,0,2079,1792,287,4332,4332,0,0,4332,4302,4255,26,5,6,0,10,30,30,0,0,0,0,4332,20,4312,4332,2084,2248,4255,42,115,032600
42,032700,0000284270452,00003670,1752,1752,0,1752,1376,376,3670,3670,0,0,3670,3638,3616,12,1,3,0,6,32,27,5,0,0,0,3670,15,3655,3670,1895,1775,3616,42,115,032700
42,032800,0000272754463,00005010,2328,2328,0,2328,1891,437,5010,5010,0,0,5010,4986,4947,16,5,6,1,11,24,20,4,0,0,0,5010,25,4985,5010,2516,2494,4947,42,115,032800
42,032901,0000208362922,00004213,2127,2127,0,2127,1610,517,4213,4213,0,0,4213,4198,4172,12,4,3,1,6,15,14,1,0,0,0,4213,25,4188,4213,2128,2085,4172,42,115,032901
42,032902,0000002339875,00001855,937,937,0,937,790,147,1855,1855,0,0,1855,1853,1845,2,3,1,0,2,2,2,0,0,0,0,1855,12,1843,1855,830,1025,1845,42,115,032902
42,990100,0000195769299,00004402,1903,1903,0,1903,1698,205,4402,4402,0,0,4402,4377,4358,11,3,4,0,1,25,24,1,0,0,0,4402,14,4388,4402,2191,2211,4358,42,117,990100
42,990200,0000154344399,00003709,1684,1684,0,1684,1492,192,3709,3709,0,0,3709,3681,3652,22,4,1,0,2,28,24,4,0,0,0,3709,18,3691,3709,1785,1924,3652,42,117,990200
42,990300,0000223606383,00003758,1731,1731,0,1731,1488,243,3758,3758,0,0,3758,3740,3709,16,7,4,0,4,18,18,0,0,0,0,3758,19,3739,3758,1847,1911,3709,42,117,990300
42,990400,0000404000317,00004022,2149,2149,0,2149,1568,581,4022,4022,0,0,4022,4007,3975,2,9,6,0,15,15,15,0,0,0,0,4022,19,4003,4022,2046,1976,3975,42,117,990400
42,990500,0000415092914,00004330,2115,2115,0,2115,1644,471,4330,4330,0,0,4330,4294,4254,7,22,10,1,0,36,26,10,0,0,0,4330,15,4315,4330,2163,2167,4254,42,117,990500
42,990600,0000136460644,00005886,2079,2079,0,2079,1913,166,5886,5886,0,0,5886,5831,5600,153,20,39,0,19,55,55,0,0,0,0,5886,51,5835,5886,2798,3088,5600,42,117,990600
42,990700,0000208332669,00005067,2239,2239,0,2239,1988,251,5067,5067,0,0,5067,5032,4986,10,7,22,2,5,35,31,4,0,0,0,5067,43,5024,5067,2471,2596,4986,42,117,990700
42,990800,0000012657304,00003328,1602,1602,0,1602,1469,133,3328,3328,0,0,3328,3321,3266,13,6,30,0,6,7,6,1,0,0,0,3328,19,3309,3328,1488,1840,3266,42,117,990800
42,990900,0000652284286,00003969,2660,2660,0,2660,1552,1108,3969,3969,0,0,3969,3946,3915,13,11,4,0,3,23,23,0,0,0,0,3969,8,3961,3969,1974,1995,3915,42,117,990900
42,991000,0000533787981,00002902,1731,1731,0,1731,1113,618,2902,2902,0,0,2902,2890,2874,3,7,4,1,1,12,11,1,0,0,0,2902,8,2894,2902,1490,1412,2874,42,117,991000
42,990100,0000159491254,00008960,2088,2088,0,2088,1979,109,8960,8960,0,0,8960,8665,6780,1742,14,100,2,27,295,268,27,0,0,0,8960,994,7966,8960,6332,2628,6780,42,119,990100
42,990200,0000406905307,00006104,2980,2980,0,2980,2184,796,6104,6104,0,0,6104,6063,6007,22,8,13,2,11,41,38,0,3,0,0,6104,40,6064,6104,3053,3051,6007,42,119,990200
42,990300,0000004950427,00003664,1629,1629,0,1629,1529,100,3664,3664,0,0,3664,3638,3597,16,3,9,1,12,26,26,0,0,0,0,3664,27,3637,3664,1710,1954,3597,42,119,990300
42,990400,0000082240562,00003837,1571,1571,0,1571,1406,165,3837,3837,0,0,3837,3813,3763,12,16,15,1,6,24,21,3,0,0,0,3837,13,3824,3837,1971,1866,3763,42,119,990400
42,990500,0000123680815,00007709,2584,2584,0,2584,2479,105,7709,7709,0,0,7709,7656,6704,870,14,47,1,20,53,51,2,0,0,0,7709,310,7399,7709,4572,3137,6704,42,119,990500
42,990600,0000040505975,00005730,1894,1894,0,1894,1823,71,5730,5730,0,0,5730,5696,5499,69,2,102,4,20,34,34,0,0,0,0,5730,107,5623,5730,2779,2951,5499,42,119,990600
42,990700,0000002542604,00005620,1938,1938,0,1938,1778,160,5620,5620,0,0,5620,5522,5146,147,10,157,6,56,98,93,5,0,0,0,5620,131,5489,5620,2619,3001,5146,42,119,990700
42,200000,0000221967326,00003514,1613,1613,0,1613,1369,244,3514,3514,0,0,3514,3491,3474,3,8,5,0,1,23,23,0,0,0,0,3514,9,3505,3514,1792,1722,3474,42,121,200000
42,200100,0000209446820,00004253,1763,1763,0,1763,1575,188,4253,4253,0,0,4253,4233,4208,11,4,6,0,4,20,19,1,0,0,0,4253,12,4241,4253,2119,2134,4208,42,121,200100
42,200200,0000194164586,00006261,2465,2465,0,2465,2151,314,6261,6261,0,0,6261,6205,5953,200,13,8,1,30,56,50,6,0,0,0,6261,58,6203,6261,3230,3031,5953,42,121,200200
42,200300,0000004733411,00001857,787,787,0,787,737,50,1857,1857,0,0,1857,1832,1745,62,5,8,1,11,25,23,2,0,0,0,1857,15,1842,1857,819,1038,1745,42,121,200300
42,200400,0000004236441,00002642,1333,1333,0,1333,1224,109,2642,2642,0,0,2642,2594,2513,67,1,10,0,3,48,44,4,0,0,0,2642,10,2632,2642,1192,1450,2513,42,121,200400
42,200500,0000003002383,00002713,1161,1161,0,1161,1069,92,2713,2713,0,0,2713,2687,2577,96,0,6,0,8,26,26,0,0,0,0,2713,23,2690,2713,1324,1389,2577,42,121,200500
42,200600,0000096759332,00005331,2245,2245,0,2245,2093,152,5331,5331,0,0,5331,5304,5264,17,7,10,0,6,27,27,0,0,0,0,5331,15,5316,5331,2538,2793,5264,42,121,200600
42,200700,0000003268268,00002470,1177,1177,0,1177,1009,168,2470,2470,0,0,2470,2458,2419,24,11,2,0,2,12,10,2,0,0,0,2470,25,2445,2470,1162,1308,2419,42,121,200700
42,200800,0000002444726,00002660,1191,1191,0,1191,1100,91,2660,2660,0,0,2660,2644,2592,19,7,17,0,9,16,15,1,0,0,0,2660,13,2647,2660,1281,1379,2592,42,121,200800
42,200900,0000001082305,00002799,1366,1366,0,1366,1227,139,2799,2799,0,0,2799,2775,2739,24,3,6,2,1,24,20,4,0,0,0,2799,21,2778,2799,1322,1477,2739,42,121,200900
42,201000,0000004896226,00003575,1542,1542,0,1542,1426,116,3575,3575,0,0,3575,3562,3506,35,9,8,3,1,13,12,1,0,0,0,3575,13,3562,3575,1703,1872,3506,42,121,201000
42,201100,0000291619598,00005040,2714,2714,0,2714,1990,724,5040,5040,0,0,5040,5022,4988,15,8,9,0,2,18,18,0,0,0,0,5040,18,5022,5040,2468,2572,4988,42,121,201100
42,201200,0000084059631,00003184,1378,1378,0,1378,1281,97,3184,3184,0,0,3184,3173,3157,6,5,4,0,1,11,11,0,0,0,0,3184,13,3171,3184,1563,1621,3157,42,121,201200
42,201300,0000098234712,00003830,1676,1676,0,1676,1562,114,3830,3830,0,0,3830,3818,3764,16,12,10,0,16,12,12,0,0,0,0,3830,33,3797,3830,1840,1990,3764,42,121,201300
42,201400,0000273609076,00003773,1941,1941,0,1941,1448,493,3773,3773,0,0,3773,3743,3695,23,7,15,0,3,30,30,0,0,0,0,3773,7,3766,3773,1940,1833,3695,42,121,201400
42,201500,0000254815529,00003663,2552,2552,0,2552,1486,1066,3663,3663,0,0,3663,3639,3614,8,5,8,4,0,24,22,2,0,0,0,3663,13,3650,3663,1810,1853,3614,42,121,201500
42,970100,0000311388997,00002670,1459,1459,0,1459,1083,376,2670,2670,0,0,2670,2645,2635,1,1,7,1,0,25,24,1,0,0,0,2670,10,2660,2670,1347,1323,2635,42,123,970100
42,970200,0000191039758,00004065,1716,1716,0,1716,1562,154,4065,4065,0,0,4065,4043,4003,11,7,19,0,3,22,22,0,0,0,0,4065,15,4050,4065,2071,1994,4003,42,123,970200
42,970300,0000294005068,00005819,2293,2293,0,2293,2073,220,5819,5819,0,0,5819,5780,5752,9,13,3,0,3,39,39,0,0,0,0,5819,11,5808,5819,2883,2936,5752,42,123,970300
42,970400,0000363914133,00003100,1837,1837,0,1837,1185,652,3100,3100,0,0,3100,3092,3076,8,5,0,0,3,8,8,0,0,0,0,3100,6,3094,3100,1608,1492,3076,42,123,970400
42,970500,0000103476722,00003902,1774,1774,0,1774,1532,242,3902,3902,0,0,3902,3891,3867,0,15,5,0,4,11,8,3,0,0,0,3902,13,3889,3902,1815,2087,3867,42,123,970500
42,970600,0000077624225,00003915,1659,1659,0,1659,1526,133,3915,3915,0,0,3915,3893,3826,24,10,16,2,15,22,22,0,0,0,0,3915,23,3892,3915,1949,1966,3826,42,123,970600
42,970700,0000001709186,00002775,1263,1263,0,1263,1186,77,2775,2775,0,0,2775,2767,2749,3,3,11,1,0,8,8,0,0,0,0,2775,10,2765,2775,1320,1455,2749,42,123,970700
42,970800,0000003352918,00003691,1906,1906,0,1906,1680,226,3691,3691,0,0,3691,3665,3625,12,4,20,1,3,26,26,0,0,0,0,3691,19,3672,3691,1746,1945,3625,42,123,970800
42,970900,0000002511607,00003793,1877,1877,0,1877,1699,178,3793,3793,0,0,3793,3770,3734,6,14,6,0,10,23,23,0,0,0,0,3793,11,3782,3793,1751,2042,3734,42,123,970900
42,971000,0000091674573,00002319,1071,1071,0,1071,961,110,2319,2319,0,0,2319,2314,2286,3,1,21,0,3,5,5,0,0,0,0,2319,3,2316,2319,1152,1167,2286,42,123,971000
42,971100,0000297831481,00003268,2798,2798,0,2798,1343,1455,3268,3268,0,0,3268,3249,3232,1,5,7,0,4,19,15,0,1,3,0,3268,12,3256,3268,1585,1683,3232,42,123,971100
42,971200,0000273663190,00002574,1645,1645,0,1645,1047,598,2574,2574,0,0,2574,2562,2544,6,4,1,3,4,12,12,0,0,0,0,2574,17,2557,2574,1275,1299,2544,42,123,971200
42,971400,0000275924640,00001972,1760,1760,0,1760,819,941,1972,1972,0,0,1972,1965,1957,6,0,2,0,0,7,7,0,0,0,0,1972,1,1971,1972,1004,968,1957,42,123,971400
42,704100,0000000910790,00001374,788,788,0,788,638,150,1374,1374,0,0,1374,1330,972,335,1,3,0,19,44,44,0,0,0,0,1374,31,1343,1374,677,697,972,42,125,704100
42,711000,0000185950118,00004013,1618,1618,0,1618,1549,69,4013,4013,0,0,4013,4003,3954,28,4,8,1,8,10,10,0,0,0,0,4013,20,3993,4013,2026,1987,3954,42,125,711000
42,712700,0000001612249,00001576,703,703,0,703,656,47,1576,1576,0,0,1576,1550,1517,23,1,1,0,8,26,25,1,0,0,0,1576,39,1537,1576,731,845,1517,42,125,712700
42,713700,0000089053243,00004567,1928,1928,0,1928,1813,115,4567,4567,0,0,4567,4545,4449,83,3,5,0,5,22,21,1,0,0,0,4567,44,4523,4567,2265,2302,4449,42,125,713700
42,714000,0000055937018,00003175,1333,1333,0,1333,1252,81,3175,3175,0,0,3175,3153,3065,78,5,4,0,1,22,17,5,0,0,0,3175,10,3165,3175,1564,1611,3065,42,125,714000
42,715700,0000000818318,00001866,954,954,0,954,850,104,1866,1866,0,0,1866,1844,1713,122,3,0,2,4,22,20,2,0,0,0,1866,6,1860,1866,890,976,1713,42,125,715700
42,721000,0000188325927,00004497,1796,1796,0,1796,1684,112,4497,4497,0,0,4497,4456,4417,30,5,0,4,0,41,33,8,0,0,0,4497,7,4490,4497,2306,2191,4417,42,125,721000
42,722700,0000092294121,00003422,1348,1348,0,1348,1279,69,3422,3422,0,0,3422,3407,3302,102,0,3,0,0,15,15,0,0,0,0,3422,3,3419,3422,1711,1711,3302,42,125,722700
42,731000,0000191759817,00006169,2408,2408,0,2408,2283,125,6169,6169,0,0,6169,6135,6106,12,4,7,2,4,34,34,0,0,0,0,6169,15,6154,6169,3027,3142,6106,42,125,731000
42,732000,0000321440257,00007526,2836,2836,0,2836,2649,187,7526,7526,0,0,7526,7501,7464,15,6,13,0,3,25,23,2,0,0,0,7526,24,7502,7526,3817,3709,7464,42,125,732000
42,741100,0000030666759,00004107,1599,1599,0,1599,1531,68,4107,4107,0,0,4107,4086,4029,49,1,4,0,3,21,20,1,0,0,0,4107,21,4086,4107,2038,2069,4029,42,125,741100
42,741200,0000010623308,00001961,760,760,0,760,727,33,1961,1961,0,0,1961,1947,1918,19,1,2,2,5,14,14,0,0,0,0,1961,11,1950,1961,951,1010,1918,42,125,741200
42,741300,0000019566874,00003190,1392,1392,0,1392,1329,63,3190,3190,0,0,3190,3177,3068,80,6,16,2,5,13,13,0,0,0,0,3190,20,3170,3190,1507,1683,3068,42,125,741300
42,741400,0000007375839,00000498,254,254,0,254,207,47,498,498,0,0,498,497,489,6,0,2,0,0,1,1,0,0,0,0,498,0,498,498,251,247,489,42,125,741400
42,742100,0000025516228,00005315,2187,2187,0,2187,2097,90,5315,5315,0,0,5315,5285,5027,243,1,7,1,6,30,27,3,0,0,0,5315,21,5294,5315,2531,2784,5027,42,125,742100
42,742200,0000038003536,00001839,751,751,0,751,717,34,1839,1839,0,0,1839,1827,1798,20,1,2,3,3,12,12,0,0,0,0,1839,5,1834,1839,905,934,1798,42,125,742200
42,743700,0000000950178,00001314,668,668,0,668,614,54,1314,1314,0,0,1314,1299,1241,48,1,7,0,2,15,13,2,0,0,0,1314,5,1309,1314,612,702,1241,42,125,743700
42,744100,0000003672660,00005289,2645,2645,0,2645,2429,216,5289,5289,0,0,5289,5188,4757,378,4,36,2,11,101,87,13,1,0,0,5289,41,5248,5289,2464,2825,4757,42,125,744100
42,744200,0000002346476,00003318,1499,1499,0,1499,1380,119,3318,3318,0,0,3318,3290,3076,184,1,19,5,5,28,26,2,0,0,0,3318,21,3297,3318,1549,1769,3076,42,125,744200
42,745100,0000016431781,00006424,2752,2752,0,2752,2608,144,6424,6424,0,0,6424,6398,6164,142,1,74,2,15,26,26,0,0,0,0,6424,43,6381,6424,3062,3362,6164,42,125,745100
42,745200,0000054281592,00003633,1404,1404,0,1404,1367,37,3633,3633,0,0,3633,3617,3536,67,0,7,0,7,16,14,2,0,0,0,3633,18,3615,3633,1831,1802,3536,42,125,745200
42,746100,0000010030174,00005979,2219,2219,0,2219,2159,60,5979,5979,0,0,5979,5963,5857,51,2,44,0,9,16,15,1,0,0,0,5979,47,5932,5979,2865,3114,5857,42,125,746100
42,746200,0000009203243,00003508,1257,1257,0,1257,1231,26,3508,3508,0,0,3508,3495,3451,12,2,20,0,10,13,13,0,0,0,0,3508,23,3485,3508,1731,1777,3451,42,125,746200
42,746300,0000031511569,00008079,2745,2745,0,2745,2636,109,8079,8079,0,0,8079,8043,7873,21,1,127,5,16,36,33,2,1,0,0,8079,57,8022,8079,3929,4150,7873,42,125,746300
42,751100,0000025006371,00005391,2319,2319,0,2319,2220,99,5391,5391,0,0,5391,5337,5222,95,4,8,0,8,54,53,1,0,0,0,5391,24,5367,5391,2515,2876,5222,42,125,751100
42,751200,0000013558957,00003435,1452,1452,0,1452,1359,93,3435,3435,0,0,3435,3397,3209,171,2,9,0,6,38,38,0,0,0,0,3435,17,3418,3435,1648,1787,3209,42,125,751200
42,752700,0000018844729,00004818,2052,2052,0,2052,1964,88,4818,4818,0,0,4818,4788,4642,116,8,19,0,3,30,28,2,0,0,0,4818,17,4801,4818,2184,2634,4642,42,125,752700
42,753700,0000001183027,00001930,983,983,0,983,903,80,1930,1930,0,0,1930,1911,1815,82,4,7,2,1,19,17,1,1,0,0,1930,4,1926,1930,918,1012,1815,42,125,753700
42,754200,0000002554000,00003212,1162,1162,0,1162,1051,111,3212,3212,0,0,3212,3157,2892,230,6,20,0,9,55,51,4,0,0,0,3212,31,3181,3212,1577,1635,2892,42,125,754200
42,754300,0000001173951,00003879,1862,1862,0,1862,1632,230,3879,3879,0,0,3879,3775,2740,973,1,29,3,29,104,90,13,1,0,0,3879,36,3843,3879,1735,2144,2740,42,125,754300
42,754400,0000000774899,00002195,1004,1004,0,1004,888,116,2195,2195,0,0,2195,2138,1788,322,8,5,0,15,57,57,0,0,0,0,2195,20,2175,2195,1025,1170,1788,42,125,754400
42,754500,0000001430622,00002855,1416,1416,0,1416,1263,153,2855,2855,0,0,2855,2804,2570,217,1,3,0,13,51,49,2,0,0,0,2855,22,2833,2855,1318,1537,2570,42,125,754500
42,754600,0000000761543,00001753,879,879,0,879,787,92,1753,1753,0,0,1753,1714,1539,152,6,9,0,8,39,37,2,0,0,0,1753,4,1749,1753,828,925,1539,42,125,754600
42,755100,0000014770131,00003280,1566,1566,0,1566,1505,61,3280,3280,0,0,3280,3268,3193,63,0,4,1,7,12,11,1,0,0,0,3280,16,3264,3280,1386,1894,3193,42,125,755100
42,755200,0000045067144,00004707,1878,1878,0,1878,1815,63,4707,4707,0,0,4707,4688,4582,63,4,35,0,4,19,19,0,0,0,0,4707,16,4691,4707,2299,2408,4582,42,125,755200
42,755700,0000116149945,00003960,1566,1566,0,1566,1492,74,3960,3960,0,0,3960,3935,3903,24,5,3,0,0,25,25,0,0,0,0,3960,7,3953,3960,1945,2015,3903,42,125,755700
42,761000,0000147820917,00005663,2380,2380,0,2380,2216,164,5663,5663,0,0,5663,5641,5614,11,0,7,0,9,22,21,1,0,0,0,5663,13,5650,5663,2794,2869,5614,42,125,761000
42,762000,0000087498142,00002867,1207,1207,0,1207,1139,68,2867,2867,0,0,2867,2849,2774,66,5,2,0,2,18,18,0,0,0,0,2867,3,2864,2867,1401,1466,2774,42,125,762000
42,763700,0000042172126,00001793,764,764,0,764,722,42,1793,1793,0,0,1793,1776,1692,68,8,7,1,0,17,17,0,0,0,0,1793,11,1782,1793,904,889,1692,42,125,763700
42,764000,0000011479045,00003717,1762,1762,0,1762,1609,153,3717,3717,0,0,3717,3659,3579,71,3,2,0,4,58,58,0,0,0,0,3717,22,3695,3717,1762,1955,3579,42,125,764000
42,771100,0000081841677,00004991,2045,2045,0,2045,1967,78,4991,4991,0,0,4991,4962,4923,29,1,6,0,3,29,17,12,0,0,0,4991,6,4985,4991,2515,2476,4923,42,125,771100
42,771200,0000010901259,00003589,1605,1605,0,1605,1541,64,3589,3589,0,0,3589,3569,3498,50,1,9,0,11,20,20,0,0,0,0,3589,32,3557,3589,1716,1873,3498,42,125,771200
42,772700,0000002675926,00002262,1068,1068,0,1068,962,106,2262,2262,0,0,2262,2238,2194,25,3,11,2,3,24,12,0,0,12,0,2262,2,2260,2262,1072,1190,2194,42,125,772700
42,773100,0000004266205,00003194,1675,1675,0,1675,1497,178,3194,3194,0,0,3194,3164,3054,83,3,6,0,18,30,27,3,0,0,0,3194,24,3170,3194,1488,1706,3054,42,125,773100
42,773200,0000000721314,00001567,707,707,0,707,642,65,1567,1567,0,0,1567,1544,1466,72,1,3,0,2,23,19,4,0,0,0,1567,10,1557,1567,704,863,1466,42,125,773200
42,774700,0000034976342,00005677,2344,2344,0,2344,2265,79,5677,5677,0,0,5677,5664,5578,62,3,6,3,12,13,13,0,0,0,0,5677,42,5635,5677,2736,2941,5578,42,125,774700
42,775200,0000002930594,00002947,1557,1557,0,1557,1302,255,2947,2947,0,0,2947,2874,2354,488,7,14,0,11,73,71,2,0,0,0,2947,71,2876,2947,1310,1637,2354,42,125,775200
42,775300,0000001992788,00002706,1401,1401,0,1401,1167,234,2706,2706,0,0,2706,2648,2287,351,1,1,1,7,58,55,3,0,0,0,2706,43,2663,2706,1249,1457,2287,42,125,775300
42,781700,0000055125204,00004461,1878,1878,0,1878,1765,113,4461,4461,0,0,4461,4442,4365,64,3,7,0,3,19,19,0,0,0,0,4461,28,4433,4461,2179,2282,4365,42,125,781700
42,782700,0000000680567,00001409,706,706,0,706,650,56,1409,1409,0,0,1409,1397,1369,25,1,0,0,2,12,12,0,0,0,0,1409,18,1391,1409,633,776,1369,42,125,782700
42,783200,0000000945819,00002829,1584,1584,0,1584,1352,232,2829,2829,0,0,2829,2809,2705,90,5,7,0,2,20,20,0,0,0,0,2829,19,2810,2829,1274,1555,2705,42,125,783200
42,783300,0000001053957,00002042,1072,1072,0,1072,906,166,2042,2042,0,0,2042,2023,1938,68,1,7,0,9,19,17,2,0,0,0,2042,16,2026,2042,912,1130,1938,42,125,783300
42,784000,0000013752536,00002983,1385,1385,0,1385,1304,81,2983,2983,0,0,2983,2975,2939,19,0,17,0,0,8,8,0,0,0,0,2983,6,2977,2983,1435,1548,2939,42,125,784000
42,791000,0000009715104,00001749,788,788,0,788,744,44,1749,1749,0,0,1749,1742,1715,17,1,4,0,5,7,7,0,0,0,0,1749,5,1744,1749,818,931,1715,42,125,791000
42,792100,0000026264123,00002739,1367,1367,0,1367,1260,107,2739,2739,0,0,2739,2721,2617,75,2,24,0,3,18,17,1,0,0,0,2739,15,2724,2739,1258,1481,2617,42,125,792100
42,792200,0000002596149,00002669,797,797,0,797,690,107,2669,2669,0,0,2669,2635,2466,143,7,15,0,4,34,30,4,0,0,0,2669,13,2656,2669,1335,1334,2466,42,125,792200
42,793700,0000003347806,00001075,527,527,0,527,459,68,1075,1075,0,0,1075,1071,1055,7,1,0,0,8,4,4,0,0,0,0,1075,4,1071,1075,528,547,1055,42,125,793700
42,794700,0000034307564,00003390,1455,1455,0,1455,1359,96,3390,3390,0,0,3390,3377,3351,6,5,7,0,8,13,10,3,0,0,0,3390,9,3381,3390,1633,1757,3351,42,125,794700
42,795700,0000013232978,00002524,1210,1210,0,1210,1048,162,2524,2524,0,0,2524,2500,2426,60,10,1,0,3,24,24,0,0,0,0,2524,12,2512,2524,1172,1352,2426,42,125,795700
42,960100,0000229064865,00001544,1280,1280,0,1280,630,650,1544,1544,0,0,1544,1539,1526,2,0,6,0,5,5,5,0,0,0,0,1544,8,1536,1544,800,744,1526,42,127,960100
42,960200,0000411084419,00003337,2464,2464,0,2464,1346,1118,3337,3337,0,0,3337,3323,3304,2,4,8,0,5,14,14,0,0,0,0,3337,39,3298,3337,1684,1653,3304,42,127,960200
42,960300,0000103637443,00002169,1210,1210,0,1210,866,344,2169,2169,0,0,2169,2165,2143,11,5,5,0,1,4,4,0,0,0,0,2169,4,2165,2169,1082,1087,2143,42,127,960300
42,960400,0000201494063,00003035,1465,1465,0,1465,1150,315,3035,3035,0,0,3035,3020,2994,10,0,15,0,1,15,12,3,0,0,0,3035,24,3011,3035,1522,1513,2994,42,127,960400
42,960500,0000204944989,00003662,2248,2248,0,2248,1454,794,3662,3662,0,0,3662,3652,3603,22,12,12,0,3,10,10,0,0,0,0,3662,37,3625,3662,1827,1835,3603,42,127,960500
42,960600,0000142699212,00004618,2257,2257,0,2257,1854,403,4618,4618,0,0,4618,4580,4509,31,3,20,0,17,38,38,0,0,0,0,4618,86,4532,4618,2206,2412,4509,42,127,960600
42,960700,0000010672151,00004874,2414,2414,0,2414,2166,248,4874,4874,0,0,4874,4844,4759,32,7,38,0,8,30,28,2,0,0,0,4874,92,4782,4874,2218,2656,4759,42,127,960700
42,960800,0000093117769,00004318,1926,1926,0,1926,1669,257,4318,4318,0,0,4318,4288,4220,24,15,22,0,7,30,28,2,0,0,0,4318,47,4271,4318,2069,2249,4220,42,127,960800
42,960900,0000126358051,00005011,1626,1626,0,1626,1411,215,5011,5011,0,0,5011,4985,4427,403,5,16,0,134,26,26,0,0,0,0,5011,168,4843,5011,3007,2004,4427,42,127,960900
42,961000,0000072764796,00004361,3524,3524,0,3524,1632,1892,4361,4361,0,0,4361,4335,4236,70,5,8,0,16,26,21,5,0,0,0,4361,69,4292,4361,2109,2252,4236,42,127,961000
42,961100,0000072814622,00002959,3398,3398,0,3398,1176,2222,2959,2959,0,0,2959,2940,2889,25,2,11,1,12,19,19,0,0,0,0,2959,74,2885,2959,1454,1505,2889,42,127,961100
42,961200,0000079739785,00003664,2757,2757,0,2757,1400,1357,3664,3664,0,0,3664,3619,3564,32,6,7,0,10,45,43,2,0,0,0,3664,52,3612,3664,1865,1799,3564,42,127,961200
42,961300,0000108490055,00002531,1570,1570,0,1570,961,609,2531,2531,0,0,2531,2501,2441,41,4,6,0,9,30,30,0,0,0,0,2531,37,2494,2531,1266,1265,2441,42,127,961300
42,961400,0000031780499,00001639,2454,2454,0,2454,635,1819,1639,1639,0,0,1639,1627,1545,52,1,8,0,21,12,12,0,0,0,0,1639,74,1565,1639,833,806,1545,42,127,961400
42,800100,0000000618445,00001480,904,904,0,904,730,174,1480,1480,0,0,1480,1440,1113,319,2,1,0,5,40,38,2,0,0,0,1480,18,1462,1480,694,786,1113,42,129,800100
42,800200,0000000363989,00001562,767,767,0,767,662,105,1562,1562,0,0,1562,1523,1266,247,4,3,0,3,39,34,5,0,0,0,1562,28,1534,1562,757,805,1266,42,129,800200
42,800300,0000000922095,00002625,1305,1305,0,1305,1197,108,2625,2625,0,0,2625,2602,2429,157,4,4,1,7,23,21,2,0,0,0,2625,18,2607,2625,1178,1447,2429,42,129,800300
42,800400,0000001425991,00001525,788,788,0,788,734,54,1525,1525,0,0,1525,1513,1463,44,1,2,0,3,12,9,3,0,0,0,1525,11,1514,1525,700,825,1463,42,129,800400
42,800500,0000002360695,00002789,1284,1284,0,1284,1242,42,2789,2789,0,0,2789,2773,2698,64,0,7,0,4,16,16,0,0,0,0,2789,9,2780,2789,1326,1463,2698,42,129,800500
42,800600,0000000618185,00002824,1356,1356,0,1356,1144,212,2824,2824,0,0,2824,2773,2245,488,4,10,1,25,51,46,5,0,0,0,2824,23,2801,2824,1382,1442,2245,42,129,800600
42,800700,0000001435573,00002656,1666,1666,0,1666,1329,337,2656,2656,0,0,2656,2572,1930,607,9,9,0,17,84,76,7,1,0,0,2656,38,2618,2656,1221,1435,1930,42,129,800700
42,800800,0000001126460,00001979,860,860,0,860,828,32,1979,1979,0,0,1979,1966,1918,42,0,2,0,4,13,12,1,0,0,0,1979,12,1967,1979,941,1038,1918,42,129,800800
42,800900,0000003256530,00002928,1355,1355,0,1355,1242,113,2928,2928,0,0,2928,2872,2661,202,4,4,0,1,56,55,1,0,0,0,2928,13,2915,2928,1329,1599,2661,42,129,800900
42,801001,0000002972531,00004274,1726,1726,0,1726,1686,40,4274,4274,0,0,4274,4254,4230,16,1,3,0,4,20,20,0,0,0,0,4274,19,4255,4274,2023,2251,4230,42,129,801001
42,801002,0000016125404,00002824,1237,1237,0,1237,1169,68,2824,2824,0,0,2824,2804,2714,67,2,18,2,1,20,19,1,0,0,0,2824,6,2818,2824,1348,1476,2714,42,129,801002
42,801100,0000010868776,00005510,2361,2361,0,2361,2278,83,5510,5510,0,0,5510,5472,5405,34,1,24,0,8,38,36,2,0,0,0,5510,31,5479,5510,2566,2944,5405,42,129,801100
42,801200,0000056259828,00005706,2273,2273,0,2273,2171,102,5706,5706,0,0,5706,5675,5626,25,12,9,0,3,31,29,2,0,0,0,5706,8,5698,5706,2870,2836,5626,42,129,801200
42,801300,0000026620232,00004099,1727,1727,0,1727,1636,91,4099,4099,0,0,4099,4075,4022,35,1,3,1,13,24,20,4,0,0,0,4099,18,4081,4099,1980,2119,4022,42,129,801300
42,801400,0000002115444,00002022,933,933,0,933,857,76,2022,2022,0,0,2022,1993,1949,32,8,1,0,3,29,24,5,0,0,0,2022,2,2020,2022,985,1037,1949,42,129,801400
42,801500,0000000887711,00002689,1384,1384,0,1384,1213,171,2689,2689,0,0,2689,2669,2594,72,1,0,1,1,20,18,2,0,0,0,2689,12,2677,2689,1231,1458,2594,42,129,801500
42,801600,0000000530703,00001486,830,830,0,830,677,153,1486,1486,0,0,1486,1452,1347,85,3,12,0,5,34,34,0,0,0,0,1486,6,1480,1486,664,822,1347,42,129,801600
42,801701,0000039311363,00002240,914,914,0,914,856,58,2240,2240,0,0,2240,2229,2158,63,1,7,0,0,11,11,0,0,0,0,2240,10,2230,2240,1132,1108,2158,42,129,801701
42,801702,0000045228930,00004644,1860,1860,0,1860,1779,81,4644,4644,0,0,4644,4638,4604,23,2,4,0,5,6,6,0,0,0,0,4644,10,4634,4644,2330,2314,4604,42,129,801702
42,801703,0000036870673,00002740,1101,1101,0,1101,1030,71,2740,2740,0,0,2740,2732,2706,21,0,3,0,2,8,8,0,0,0,0,2740,8,2732,2740,1322,1418,2706,42,129,801703
42,801800,0000112789909,00006494,2712,2712,0,2712,2530,182,6494,6494,0,0,6494,6468,6384,63,1,7,0,13,26,25,1,0,0,0,6494,28,6466,6494,3203,3291,6384,42,129,801800
42,801900,0000122087654,00006939,3117,3117,0,3117,2932,185,6939,6939,0,0,6939,6890,6792,84,6,4,1,3,49,45,0,1,3,0,6939,11,6928,6939,3394,3545,6792,42,129,801900
42,802001,0000033795580,00002401,897,897,0,897,842,55,2401,2401,0,0,2401,2393,2346,10,1,30,0,6,8,8,0,0,0,0,2401,24,2377,2401,1230,1171,2346,42,129,802001
42,802002,0000013581748,00007254,3130,3130,0,3130,2930,200,7254,7254,0,0,7254,7206,7036,34,1,131,1,3,48,39,4,0,5,0,7254,40,7214,7254,3530,3724,7036,42,129,802002
42,802101,0000016977079,00005163,2057,2057,0,2057,1985,72,5163,5163,0,0,5163,5139,4821,40,7,252,0,19,24,17,6,1,0,0,5163,24,5139,5163,2471,2692,4821,42,129,802101
42,802102,0000022100638,00005160,2050,2050,0,2050,1979,71,5160,5160,0,0,5160,5132,4975,30,1,123,1,2,28,25,1,0,2,0,5160,17,5143,5160,2588,2572,4975,42,129,802102
42,802103,0000012962725,00002286,914,914,0,914,872,42,2286,2286,0,0,2286,2267,2149,16,0,100,0,2,19,16,3,0,0,0,2286,12,2274,2286,1140,1146,2149,42,129,802103
42,802200,0000003244929,00003205,1621,1621,0,1621,1516,105,3205,3205,0,0,3205,3188,3149,22,1,10,0,6,17,17,0,0,0,0,3205,13,3192,3205,1489,1716,3149,42,129,802200
42,802301,0000022838381,00005983,2265,2265,0,2265,2192,73,5983,5983,0,0,5983,5959,5879,44,11,18,1,6,24,21,0,0,3,0,5983,22,5961,5983,2933,3050,5879,42,129,802301
42,802302,0000027963364,00009489,3261,3261,0,3261,3188,73,9489,9489,0,0,9489,9450,9347,25,1,57,3,17,39,39,0,0,0,0,9489,49,9440,9489,4708,4781,9347,42,129,802302
42,802400,0000029512673,00004328,1656,1656,0,1656,1585,71,4328,4328,0,0,4328,4313,4289,5,5,14,0,0,15,15,0,0,0,0,4328,16,4312,4328,2097,2231,4289,42,129,802400
42,802500,0000001455790,00002413,1115,1115,0,1115,1058,57,2413,2413,0,0,2413,2386,2331,42,4,4,2,3,27,27,0,0,0,0,2413,17,2396,2413,1118,1295,2331,42,129,802500
42,802600,0000001626996,00003920,1768,1768,0,1768,1608,160,3920,3920,0,0,3920,3870,3740,114,4,0,2,10,50,50,0,0,0,0,3920,15,3905,3920,1841,2079,3740,42,129,802600
42,802700,0000001682174,00002019,984,984,0,984,921,63,2019,2019,0,0,2019,2011,1973,33,1,4,0,0,8,8,0,0,0,0,2019,5,2014,2019,943,1076,1973,42,129,802700
42,802800,0000001886517,00002762,1459,1459,0,1459,1225,234,2762,2762,0,0,2762,2673,2288,371,0,2,0,12,89,81,4,4,0,0,2762,16,2746,2762,1279,1483,2288,42,129,802800
42,802900,0000009980779,00005123,1966,1966,0,1966,1893,73,5123,5123,0,0,5123,5101,5045,25,2,17,2,10,22,20,2,0,0,0,5123,38,5085,5123,2508,2615,5045,42,129,802900
42,803000,0000002814358,00005245,2670,2670,0,2670,2465,205,5245,5245,0,0,5245,5204,5082,45,8,52,1,16,41,35,4,2,0,0,5245,31,5214,5245,2469,2776,5082,42,129,803000
42,803100,0000009601087,00004238,1728,1728,0,1728,1659,69,4238,4238,0,0,4238,4227,4201,13,0,13,0,0,11,11,0,0,0,0,4238,18,4220,4238,2014,2224,4201,42,129,803100
42,803200,0000017326563,00002782,1144,1144,0,1144,1085,59,2782,2782,0,0,2782,2777,2759,4,2,12,0,0,5,5,0,0,0,0,2782,12,2770,2782,1384,1398,2759,42,129,803200
42,803301,0000007344049,00005822,2469,2469,0,2469,2375,94,5822,5822,0,0,5822,5797,5751,13,2,24,3,4,25,23,2,0,0,0,5822,34,5788,5822,2853,2969,5751,42,129,803301
42,803302,0000011217967,00003584,1466,1466,0,1466,1436,30,3584,3584,0,0,3584,3569,3553,5,1,10,0,0,15,11,4,0,0,0,3584,11,3573,3584,1693,1891,3553,42,129,803302
42,803400,0000004109892,00002131,858,858,0,858,846,12,2131,2131,0,0,2131,2128,2112,5,0,11,0,0,3,3,0,0,0,0,2131,5,2126,2131,1021,1110,2112,42,129,803400
42,803500,0000016403012,00008239,2991,2991,0,2991,2923,68,8239,8239,0,0,8239,8210,8138,30,7,32,1,2,29,29,0,0,0,0,8239,26,8213,8239,3988,4251,8138,42,129,803500
42,803600,0000008182398,00001926,812,812,0,812,765,47,1926,1926,0,0,1926,1921,1886,10,4,15,6,0,5,5,0,0,0,0,1926,6,1920,1926,934,992,1886,42,129,803600
42,803700,0000016154591,00004125,1678,1678,0,1678,1592,86,4125,4125,0,0,4125,4105,4048,24,1,27,0,5,20,19,1,0,0,0,4125,8,4117,4125,1916,2209,4048,42,129,803700
42,803800,0000039804383,00004897,2088,2088,0,2088,1978,110,4897,4897,0,0,4897,4873,4762,67,0,38,0,6,24,20,4,0,0,0,4897,18,4879,4897,2356,2541,4762,42,129,803800
42,803900,0000006082780,00007128,3333,3333,0,3333,3131,202,7128,7128,0,0,7128,7066,6719,230,7,79,1,30,62,55,7,0,0,0,7128,104,7024,7128,3071,4057,6719,42,129,803900
42,804000,0000001334455,00001572,805,805,0,805,726,79,1572,1572,0,0,1572,1538,1397,134,0,1,0,6,34,27,6,1,0,0,1572,13,1559,1572,741,831,1397,42,129,804000
42,804100,0000001272829,00003049,1711,1711,0,1711,1522,189,3049,3049,0,0,3049,2957,2779,147,4,16,0,11,92,90,2,0,0,0,3049,29,3020,3049,1464,1585,2779,42,129,804100
42,804200,0000002311605,00004152,1889,1889,0,1889,1769,120,4152,4152,0,0,4152,4105,3961,110,3,16,1,14,47,44,3,0,0,0,4152,26,4126,4152,1874,2278,3961,42,129,804200
42,804300,0000001034805,00002398,1187,1187,0,1187,1097,90,2398,2398,0,0,2398,2376,2317,42,3,4,1,9,22,20,2,0,0,0,2398,11,2387,2398,1132,1266,2317,42,129,804300
42,804400,0000001912906,00002280,1129,1129,0,1129,1048,81,2280,2280,0,0,2280,2265,2240,15,1,2,0,7,15,13,2,0,0,0,2280,12,2268,2280,1066,1214,2240,42,129,804400
42,804501,0000017696634,00004824,1818,1818,0,1818,1751,67,4824,4824,0,0,4824,4808,4709,27,1,58,5,8,16,16,0,0,0,0,4824,19,4805,4824,2371,2453,4709,42,129,804501
42,804502,0000009973092,00005721,2655,2655,0,2655,2514,141,5721,5721,0,0,5721,5691,5523,49,6,104,2,7,30,26,4,0,0,0,5721,41,5680,5721,2651,3070,5523,42,129,804502
42,804600,0000004765019,00004138,1601,1601,0,1601,1506,95,4138,4138,0,0,4138,4128,3628,482,10,7,0,1,10,10,0,0,0,0,4138,98,4040,4138,2391,1747,3628,42,129,804600
42,804701,0000018997938,00003317,1269,1269,0,1269,1240,29,3317,3317,0,0,3317,3305,3275,22,3,3,0,2,12,11,1,0,0,0,3317,10,3307,3317,1666,1651,3275,42,129,804701
42,804702,0000007430625,00005591,2025,2025,0,2025,1938,87,5591,5591,0,0,5591,5571,5361,161,6,32,3,8,20,20,0,0,0,0,5591,17,5574,5591,2701,2890,5361,42,129,804702
42,804801,0000008163141,00001840,972,972,0,972,881,91,1840,1840,0,0,1840,1831,1772,23,0,34,0,2,9,9,0,0,0,0,1840,14,1826,1840,896,944,1772,42,129,804801
42,804802,0000028944688,00006124,2477,2477,0,2477,2383,94,6124,6124,0,0,6124,6103,6004,62,7,22,2,6,21,21,0,0,0,0,6124,22,6102,6124,2966,3158,6004,42,129,804802
42,804900,0000056433191,00005508,2490,2490,0,2490,2335,155,5508,5508,0,0,5508,5482,5394,44,8,25,0,11,26,25,1,0,0,0,5508,30,5478,5508,2747,2761,5394,42,129,804900
42,805000,0000040508442,00003953,1711,1711,0,1711,1610,101,3953,3953,0,0,3953,3939,3911,5,11,6,1,5,14,13,1,0,0,0,3953,25,3928,3953,1925,2028,3911,42,129,805000
42,805100,0000029187429,00002913,1235,1235,0,1235,1176,59,2913,2913,0,0,2913,2903,2889,7,0,4,0,3,10,10,0,0,0,0,2913,12,2901,2913,1430,1483,2889,42,129,805100
42,805200,0000001820607,00002359,1205,1205,0,1205,1045,160,2359,2359,0,0,2359,2313,2016,279,0,5,0,13,46,41,5,0,0,0,2359,17,2342,2359,1075,1284,2016,42,129,805200
42,805400,0000002072491,00002258,1272,1272,0,1272,1003,269,2258,2258,0,0,2258,2190,1395,765,6,9,1,14,68,68,0,0,0,0,2258,30,2228,2258,1003,1255,1395,42,129,805400
42,805500,0000003624090,00004052,1991,1991,0,1991,1868,123,4052,4052,0,0,4052,4025,3846,169,2,6,0,2,27,25,2,0,0,0,4052,24,4028,4052,1901,2151,3846,42,129,805500
42,805600,0000001130702,00002107,992,992,0,992,928,64,2107,2107,0,0,2107,2096,2053,27,1,12,2,1,11,11,0,0,0,0,2107,19,2088,2107,957,1150,2053,42,129,805600
42,805800,0000021827430,00003323,1425,1425,0,1425,1336,89,3323,3323,0,0,3323,3289,3150,123,3,1,1,11,34,32,2,0,0,0,3323,25,3298,3323,1573,1750,3150,42,129,805800
42,805900,0000061535452,00008311,3495,3495,0,3495,3254,241,8311,8311,0,0,8311,8279,8123,103,11,32,2,8,32,31,1,0,0,0,8311,36,8275,8311,4104,4207,8123,42,129,805900
42,806000,0000002938386,00003083,1410,1410,0,1410,1318,92,3083,3083,0,0,3083,3058,3006,35,5,7,0,5,25,24,1,0,0,0,3083,13,3070,3083,1429,1654,3006,42,129,806000
42,806100,0000051701197,00003831,1614,1614,0,1614,1539,75,3831,3831,0,0,3831,3811,3766,40,1,2,0,2,20,20,0,0,0,0,3831,10,3821,3831,1863,1968,3766,42,129,806100
42,806200,0000065873067,00002788,1179,1179,0,1179,1110,69,2788,2788,0,0,2788,2756,2727,16,7,3,1,2,32,31,1,0,0,0,2788,13,2775,2788,1387,1401,2727,42,129,806200
42,806300,0000001112804,00002093,999,999,0,999,911,88,2093,2093,0,0,2093,2085,2043,34,1,3,2,2,8,8,0,0,0,0,2093,5,2088,2093,995,1098,2043,42,129,806300
42,806400,0000001905441,00002679,1215,1215,0,1215,1123,92,2679,2679,0,0,2679,2669,2640,19,4,3,1,2,10,10,0,0,0,0,2679,12,2667,2679,1226,1453,2640,42,129,806400
42,806500,0000044056908,00004727,1952,1952,0,1952,1879,73,4727,4727,0,0,4727,4711,4662,30,1,14,0,4,16,16,0,0,0,0,4727,15,4712,4727,2266,2461,4662,42,129,806500
42,806600,0000040872224,00003054,1337,1337,0,1337,1263,74,3054,3054,0,0,3054,3040,3016,7,6,3,2,6,14,12,1,1,0,0,3054,8,3046,3054,1470,1584,3016,42,129,806600
42,806700,0000002011875,00003066,1433,1433,0,1433,1342,91,3066,3066,0,0,3066,3039,2980,42,7,9,0,1,27,25,2,0,0,0,3066,9,3057,3066,1387,1679,2980,42,129,806700
42,806800,0000000954940,00001662,794,794,0,794,715,79,1662,1662,0,0,1662,1656,1611,37,0,2,0,6,6,6,0,0,0,0,1662,6,1656,1662,764,898,1611,42,129,806800
42,806900,0000026859723,00004029,1700,1700,0,1700,1603,97,4029,4029,0,0,4029,4002,3975,18,0,4,0,5,27,27,0,0,0,0,4029,15,4014,4029,1911,2118,3975,42,129,806900
42,807000,0000085152242,00003562,1510,1510,0,1510,1384,126,3562,3562,0,0,3562,3550,3545,3,1,0,0,1,12,12,0,0,0,0,3562,15,3547,3562,1748,1814,3545,42,129,807000
42,807100,0000032425275,00003562,1458,1458,0,1458,1398,60,3562,3562,0,0,3562,3558,3544,7,0,1,1,5,4,4,0,0,0,0,3562,14,3548,3562,1764,1798,3544,42,129,807100
42,807200,0000058540736,00007042,2848,2848,0,2848,2718,130,7042,7042,0,0,7042,7019,6914,16,4,74,2,9,23,22,1,0,0,0,7042,20,7022,7042,3477,3565,6914,42,129,807200
42,807300,0000052698766,00005077,2129,2129,0,2129,2014,115,5077,5077,0,0,5077,5060,5034,5,14,6,0,1,17,16,1,0,0,0,5077,15,5062,5077,2484,2593,5034,42,129,807300
42,807401,0000034536708,00002314,946,946,0,946,899,47,2314,2314,0,0,2314,2306,2293,5,6,2,0,0,8,8,0,0,0,0,2314,9,2305,2314,1136,1178,2293,42,129,807401
42,807402,0000028254296,00007099,2636,2636,0,2636,2507,129,7099,7099,0,0,7099,7063,6892,42,6,99,2,22,36,35,1,0,0,0,7099,45,7054,7099,3478,3621,6892,42,129,807402
42,807500,0000001632477,00002500,1125,1125,0,1125,1063,62,2500,2500,0,0,2500,2494,2458,6,2,26,0,2,6,6,0,0,0,0,2500,5,2495,2500,1188,1312,2458,42,129,807500
42,807600,0000002637856,00002806,1424,1424,0,1424,1295,129,2806,2806,0,0,2806,2794,2768,11,5,7,0,3,12,12,0,0,0,0,2806,6,2800,2806,1307,1499,2768,42,129,807600
42,807700,0000001681894,00003688,1709,1709,0,1709,1608,101,3688,3688,0,0,3688,3678,3658,12,0,7,0,1,10,10,0,0,0,0,3688,22,3666,3688,1716,1972,3658,42,129,807700
42,807800,0000010191843,00003902,1753,1753,0,1753,1667,86,3902,3902,0,0,3902,3892,3875,9,2,6,0,0,10,10,0,0,0,0,3902,9,3893,3902,1870,2032,3875,42,129,807800
42,807900,0000141932976,00006612,2788,2788,0,2788,2575,213,6612,6612,0,0,6612,6581,6544,20,2,11,0,4,31,31,0,0,0,0,6612,16,6596,6612,3278,3334,6544,42,129,807900
42,808100,0000098294505,00004807,1930,1930,0,1930,1728,202,4807,4807,0,0,4807,4791,4636,145,1,5,1,3,16,15,1,0,0,0,4807,44,4763,4807,2430,2377,4636,42,129,808100
42,808200,0000002095664,00002991,1317,1317,0,1317,1235,82,2991,2991,0,0,2991,2983,2961,19,1,0,0,2,8,8,0,0,0,0,2991,14,2977,2991,1419,1572,2961,42,129,808200
42,808300,0000232124634,00005703,2617,2617,0,2617,2248,369,5703,5703,0,0,5703,5667,5617,13,24,2,0,11,36,35,1,0,0,0,5703,28,5675,5703,2841,2862,5617,42,129,808300
42,808400,0000238270545,00007163,3667,3667,0,3667,2994,673,7163,7163,0,0,7163,7134,7108,9,3,9,0,5,29,28,1,0,0,0,7163,22,7141,7163,3512,3651,7108,42,129,808400
42,808500,0000001260615,00001695,907,907,0,907,827,80,1695,1695,0,0,1695,1692,1691,0,0,1,0,0,3,3,0,0,0,0,1695,6,1689,1695,774,921,1691,42,129,808500
42,808600,0000250547747,00005010,2467,2467,0,2467,1949,518,5010,5010,0,0,5010,4997,4985,3,0,3,0,6,13,12,1,0,0,0,5010,23,4987,5010,2531,2479,4985,42,129,808600
42,400100,0000115830359,00003068,1522,1522,0,1522,1181,341,3068,3068,0,0,3068,3052,3029,5,7,8,0,3,16,12,3,1,0,0,3068,22,3046,3068,1480,1588,3029,42,131,400100
42,400200,0000375772824,00004071,2006,2006,0,2006,1574,432,4071,4071,0,0,4071,4029,3997,7,12,4,0,9,42,40,2,0,0,0,4071,32,4039,4071,2034,2037,3997,42,131,400200
42,400300,0000095168321,00004561,1811,1811,0,1811,1612,199,4561,4561,0,0,4561,4537,4433,57,13,24,0,10,24,23,1,0,0,0,4561,38,4523,4561,2232,2329,4433,42,131,400300
42,400400,0000080576765,00004298,1822,1822,0,1822,1624,198,4298,4298,0,0,4298,4274,4223,19,6,16,1,9,24,24,0,0,0,0,4298,33,4265,4298,2094,2204,4223,42,131,400400
42,400500,0000087209998,00004277,2018,2018,0,2018,1651,367,4277,4277,0,0,4277,4250,4185,45,1,13,1,5,27,27,0,0,0,0,4277,35,4242,4277,2247,2030,4185,42,131,400500
42,400600,0000096011929,00003555,1730,1730,0,1730,1485,245,3555,3555,0,0,3555,3541,3519,5,6,9,0,2,14,13,1,0,0,0,3555,13,3542,3555,1688,1867,3519,42,131,400600
42,400700,0000178172702,00004250,1804,1804,0,1804,1635,169,4250,4250,0,0,4250,4231,4212,11,2,3,0,3,19,19,0,0,0,0,4250,14,4236,4250,2164,2086,4212,42,131,400700
42,000100,0000000489613,00001315,876,876,0,876,684,192,1315,1315,0,0,1315,1278,734,354,7,13,1,169,37,33,4,0,0,0,1315,296,1019,1315,698,617,734,42,133,000100
42,000200,0000000387342,00002829,1361,1361,0,1361,1098,263,2829,2829,0,0,2829,2704,1328,855,13,34,1,473,125,110,15,0,0,0,2829,723,2106,2829,1323,1506,1328,42,133,000200
42,000300,0000000537825,00002215,1051,1051,0,1051,894,157,2215,2215,0,0,2215,2123,1511,360,15,102,0,135,92,84,8,0,0,0,2215,317,1898,2215,1100,1115,1511,42,133,000300
42,000400,0000000582453,00001954,904,904,0,904,815,89,1954,1954,0,0,1954,1907,1554,249,2,37,0,65,47,44,3,0,0,0,1954,146,1808,1954,951,1003,1554,42,133,000400
42,000500,0000000595307,00002388,1144,1144,0,1144,1041,103,2388,2388,0,0,2388,2309,1504,596,5,72,0,132,79,75,4,0,0,0,2388,391,1997,2388,1121,1267,1504,42,133,000500
42,000600,0000001620968,00002561,1090,1090,0,1090,1002,88,2561,2561,0,0,2561,2468,1662,606,10,23,1,166,93,93,0,0,0,0,2561,380,2181,2561,1236,1325,1662,42,133,000600
42,000700,0000000465087,00003228,1293,1293,0,1293,1035,258,3228,3228,0,0,3228,3048,884,1504,29,16,6,609,180,164,16,0,0,0,3228,1093,2135,3228,1555,1673,884,42,133,000700
42,000800,0000000863791,00002077,942,942,0,942,842,100,2077,2077,0,0,2077,2001,1314,569,2,27,2,87,76,64,12,0,0,0,2077,149,1928,2077,985,1092,1314,42,133,000800
42,000900,0000000507326,00002623,1009,1009,0,1009,892,117,2623,2623,0,0,2623,2520,1374,1027,9,39,2,69,103,96,7,0,0,0,2623,199,2424,2623,1285,1338,1374,42,133,000900
42,001000,0000000570801,00001593,663,663,0,663,555,108,1593,1593,0,0,1593,1505,535,655,6,5,0,304,88,84,2,2,0,0,1593,454,1139,1593,752,841,535,42,133,001000
42,001100,0000000503133,00003388,1409,1409,0,1409,1167,242,3388,3388,0,0,3388,3239,1772,987,15,42,0,423,149,148,1,0,0,0,3388,703,2685,3388,1647,1741,1772,42,133,001100
42,001200,0000000529451,00002637,1248,1248,0,1248,1022,226,2637,2637,0,0,2637,2561,1790,512,3,14,0,242,76,71,5,0,0,0,2637,453,2184,2637,1317,1320,1790,42,133,001200
42,001300,0000001321691,00002826,1342,1342,0,1342,1232,110,2826,2826,0,0,2826,2724,2234,289,10,26,2,163,102,101,1,0,0,0,2826,292,2534,2826,1410,1416,2234,42,133,001300
42,001400,0000002971987,00004246,1941,1941,0,1941,1862,79,4246,4246,0,0,4246,4127,3358,462,15,97,7,188,119,108,9,2,0,0,4246,340,3906,4246,1941,2305,3358,42,133,001400
42,001500,0000000778841,00003624,1500,1500,0,1500,1345,155,3624,3624,0,0,3624,3455,1974,926,24,12,3,516,169,163,6,0,0,0,3624,874,2750,3624,1654,1970,1974,42,133,001500
42,001600,0000000680989,00001464,805,805,0,805,692,113,1464,1464,0,0,1464,1434,975,333,7,15,4,100,30,29,1,0,0,0,1464,221,1243,1464,768,696,975,42,133,001600
42,010110,0000016916818,00007513,2521,2521,0,2521,2454,67,7513,7513,0,0,7513,7411,6364,715,8,221,3,100,102,96,6,0,0,0,7513,409,7104,7513,4100,3413,6364,42,133,010110
42,010120,0000011737120,00004223,1830,1830,0,1830,1788,42,4223,4223,0,0,4223,4186,3994,93,2,60,0,37,37,29,7,1,0,0,4223,70,4153,4223,2095,2128,3994,42,133,010120
42,010130,0000004914431,00003149,1190,1190,0,1190,1168,22,3149,3149,0,0,3149,3111,2916,68,2,97,0,28,38,36,0,2,0,0,3149,49,3100,3149,1541,1608,2916,42,133,010130
42,010210,0000005558663,00003269,1468,1468,0,1468,1413,55,3269,3269,0,0,3269,3250,3119,49,1,54,0,27,19,17,2,0,0,0,3269,49,3220,3269,1485,1784,3119,42,133,010210
42,010220,0000004234155,00005729,2474,2474,0,2474,2407,67,5729,5729,0,0,5729,5684,5374,97,13,156,5,39,45,44,1,0,0,0,5729,84,5645,5729,2679,3050,5374,42,133,010220
42,010300,0000002376650,00001697,727,727,0,727,698,29,1697,1697,0,0,1697,1683,1647,13,3,10,1,9,14,13,1,0,0,0,1697,25,1672,1697,807,890,1647,42,133,010300
42,010400,0000003592688,00003672,1597,1597,0,1597,1536,61,3672,3672,0,0,3672,3638,3523,75,4,25,0,11,34,33,1,0,0,0,3672,60,3612,3672,1745,1927,3523,42,133,010400
42,010510,0000009411666,00004404,1059,1059,0,1059,1017,42,4404,4404,0,0,4404,4370,4236,68,1,41,1,23,34,33,1,0,0,0,4404,85,4319,4404,1934,2470,4236,42,133,010510
42,010520,0000001910389,00002201,960,960,0,960,929,31,2201,2201,0,0,2201,2185,2108,43,1,25,0,8,16,15,1,0,0,0,2201,26,2175,2201,1059,1142,2108,42,133,010520
42,020100,0000012340040,00003474,1581,1581,0,1581,1419,162,3474,3474,0,0,3474,3430,3247,89,9,48,1,36,44,41,2,1,0,0,3474,87,3387,3474,1723,1751,3247,42,133,020100
42,020210,0000058427858,00007755,2978,2978,0,2978,2871,107,7755,7755,0,0,7755,7688,7552,33,6,72,8,17,67,62,5,0,0,0,7755,71,7684,7755,3868,3887,7552,42,133,020210
42,020220,0000021448198,00003092,1229,1229,0,1229,1190,39,3092,3092,0,0,3092,3069,3019,3,2,23,3,19,23,22,1,0,0,0,3092,28,3064,3092,1540,1552,3019,42,133,020220
42,020310,0000033537410,00002132,881,881,0,881,807,74,2132,2132,0,0,2132,2123,2102,8,2,7,0,4,9,8,1,0,0,0,2132,23,2109,2132,1080,1052,2102,42,133,020310
42,020320,0000164098533,00007174,2831,2831,0,2831,2710,121,7174,7174,0,0,7174,7122,7061,22,6,25,0,8,52,46,6,0,0,0,7174,55,7119,7174,3601,3573,7061,42,133,020320
42,020410,0000050188670,00005047,1991,1991,0,1991,1915,76,5047,5047,0,0,5047,5015,4971,9,7,19,3,6,32,32,0,0,0,0,5047,31,5016,5047,2526,2521,4971,42,133,020410
42,020420,0000040918757,00006778,2669,2669,0,2669,2588,81,6778,6778,0,0,6778,6726,6611,29,12,64,2,8,52,51,1,0,0,0,6778,43,6735,6778,3303,3475,6611,42,133,020420
42,020510,0000052215986,00003600,1359,1359,0,1359,1313,46,3600,3600,0,0,3600,3587,3538,18,3,15,1,12,13,13,0,0,0,0,3600,22,3578,3600,1857,1743,3538,42,133,020510
42,020521,0000016680396,00004875,1918,1918,0,1918,1851,67,4875,4875,0,0,4875,4838,4744,22,6,31,0,35,37,35,2,0,0,0,4875,90,4785,4875,2453,2422,4744,42,133,020521
42,020522,0000043331893,00003270,1294,1294,0,1294,1247,47,3270,3270,0,0,3270,3259,3247,2,3,5,0,2,11,9,2,0,0,0,3270,8,3262,3270,1661,1609,3247,42,133,020522
42,020600,0000090141770,00006930,2706,2706,0,2706,2630,76,6930,6930,0,0,6930,6887,6821,28,11,21,0,6,43,43,0,0,0,0,6930,23,6907,6930,3569,3361,6821,42,133,020600
42,020710,0000007427896,00005210,2196,2196,0,2196,2123,73,5210,5210,0,0,5210,5180,5052,61,19,27,0,21,30,30,0,0,0,0,5210,57,5153,5210,2550,2660,5052,42,133,020710
42,020720,0000012500449,00007749,3105,3105,0,3105,3016,89,7749,7749,0,0,7749,7687,7455,96,11,45,1,79,62,60,2,0,0,0,7749,133,7616,7749,3727,4022,7455,42,133,020720
42,020800,0000063257560,00005278,2113,2113,0,2113,2005,108,5278,5278,0,0,5278,5233,5131,71,9,14,0,8,45,36,5,2,2,0,5278,35,5243,5278,2654,2624,5131,42,133,020800
42,020910,0000022083761,00005592,2259,2259,0,2259,2068,191,5592,5592,0,0,5592,5529,5430,34,14,23,1,27,63,61,2,0,0,0,5592,95,5497,5592,2821,2771,5430,42,133,020910
42,020921,0000025135861,00006898,2658,2658,0,2658,2553,105,6898,6898,0,0,6898,6844,6703,73,2,43,3,20,54,52,2,0,0,0,6898,104,6794,6898,3393,3505,6703,42,133,020921
42,020922,0000033852272,00003975,1609,1609,0,1609,1535,74,3975,3975,0,0,3975,3948,3887,24,8,16,3,10,27,26,0,0,1,0,3975,41,3934,3975,2027,1948,3887,42,133,020922
42,021010,0000023649257,00003501,1400,1400,0,1400,1353,47,3501,3501,0,0,3501,3488,3393,45,9,30,0,11,13,13,0,0,0,0,3501,41,3460,3501,1738,1763,3393,42,133,021010
42,021020,0000022848603,00005300,2214,2214,0,2214,2130,84,5300,5300,0,0,5300,5255,5171,36,9,13,0,26,45,43,2,0,0,0,5300,63,5237,5300,2620,2680,5171,42,133,021020
42,021100,0000012416185,00003639,1636,1636,0,1636,1576,60,3639,3639,0,0,3639,3602,3417,82,6,58,1,38,37,36,1,0,0,0,3639,80,3559,3639,1752,1887,3417,42,133,021100
42,021210,0000011145095,00006331,2729,2729,0,2729,2601,128,6331,6331,0,0,6331,6244,5915,125,2,121,1,80,87,83,4,0,0,0,6331,145,6186,6331,2981,3350,5915,42,133,021210
42,021220,0000018345576,00004419,1535,1535,0,1535,1499,36,4419,4419,0,0,4419,4394,4223,96,7,48,2,18,25,24,1,0,0,0,4419,47,4372,4419,2235,2184,4223,42,133,021220
42,021300,0000001277588,00004321,2010,2010,0,2010,1897,113,4321,4321,0,0,4321,4251,4051,121,13,7,0,59,70,69,1,0,0,0,4321,128,4193,4321,2021,2300,4051,42,133,021300
42,021410,0000008520410,00004421,1983,1983,0,1983,1911,72,4421,4421,0,0,4421,4353,4131,112,2,72,0,36,68,60,3,5,0,0,4421,75,4346,4421,1924,2497,4131,42,133,021410
42,021420,0000006387593,00006086,2387,2387,0,2387,2337,50,6086,6086,0,0,6086,6045,5889,62,6,83,0,5,41,37,4,0,0,0,6086,43,6043,6086,2982,3104,5889,42,133,021420
42,021500,0000014044399,00003660,1735,1735,0,1735,1654,81,3660,3660,0,0,3660,3634,3564,21,3,27,1,18,26,22,0,0,4,0,3660,39,3621,3660,1735,1925,3564,42,133,021500
42,021600,0000022976505,00002762,1268,1268,0,1268,1187,81,2762,2762,0,0,2762,2727,2600,77,2,28,1,19,35,35,0,0,0,0,2762,44,2718,2762,1414,1348,2600,42,133,021600
42,021711,0000037442167,00002970,1104,1104,0,1104,1082,22,2970,2970,0,0,2970,2945,2908,14,9,4,2,8,25,24,0,1,0,0,2970,19,2951,2970,1503,1467,2908,42,133,021711
42,021712,0000065578390,00006127,2255,2255,0,2255,2197,58,6127,6127,0,0,6127,6081,6028,14,9,9,0,21,46,39,7,0,0,0,6127,45,6082,6127,3116,3011,6028,42,133,021712
42,021720,0000023874520,00003559,1463,1463,0,1463,1426,37,3559,3559,0,0,3559,3547,3494,11,3,21,0,18,12,12,0,0,0,0,3559,35,3524,3559,1769,1790,3494,42,133,021720
42,021800,0000026437040,00007641,2709,2709,0,2709,2637,72,7641,7641,0,0,7641,7604,7477,31,11,54,0,31,37,36,1,0,0,0,7641,59,7582,7641,3754,3887,7477,42,133,021800
42,021900,0000006591928,00006951,2934,2934,0,2934,2784,150,6951,6951,0,0,6951,6904,6744,41,14,65,3,37,47,46,1,0,0,0,6951,94,6857,6951,3389,3562,6744,42,133,021900
42,022000,0000001004163,00003622,1688,1688,0,1688,1578,110,3622,3622,0,0,3622,3600,3530,12,10,26,0,22,22,22,0,0,0,0,3622,85,3537,3622,1749,1873,3530,42,133,022000
42,022100,0000001573378,00003017,1530,1530,0,1530,1415,115,3017,3017,0,0,3017,2986,2874,44,5,20,0,43,31,30,1,0,0,0,3017,109,2908,3017,1475,1542,2874,42,133,022100
42,022200,0000004660393,00003988,1844,1844,0,1844,1774,70,3988,3988,0,0,3988,3975,3919,5,6,23,0,22,13,13,0,0,0,0,3988,49,3939,3988,1874,2114,3919,42,133,022200
42,022300,0000002216737,00003908,1920,1920,0,1920,1838,82,3908,3908,0,0,3908,3875,3769,14,6,58,8,20,33,33,0,0,0,0,3908,55,3853,3908,1842,2066,3769,42,133,022300
42,022400,0000106222339,00007984,2864,2864,0,2864,2794,70,7984,7984,0,0,7984,7934,7847,40,11,28,1,7,50,49,1,0,0,0,7984,39,7945,7984,4068,3916,7847,42,133,022400
42,022500,0000086701521,00003646,1398,1398,0,1398,1344,54,3646,3646,0,0,3646,3621,3584,3,16,9,0,9,25,21,4,0,0,0,3646,8,3638,3646,1832,1814,3584,42,133,022500
42,022600,0000072830919,00006000,2383,2383,0,2383,2286,97,6000,6000,0,0,6000,5967,5919,18,8,22,0,0,33,32,0,0,1,0,6000,32,5968,6000,2986,3014,5919,42,133,022600
42,022700,0000017245725,00006342,2987,2987,0,2987,2829,158,6342,6342,0,0,6342,6317,6089,124,5,68,2,29,25,25,0,0,0,0,6342,65,6277,6342,2890,3452,6089,42,133,022700
42,022800,0000016390939,00007008,2911,2911,0,2911,2820,91,7008,7008,0,0,7008,6955,6775,86,12,74,0,8,53,52,1,0,0,0,7008,88,6920,7008,3384,3624,6775,42,133,022800
42,022910,0000016317970,00006415,2802,2802,0,2802,2684,118,6415,6415,0,0,6415,6335,6036,126,3,123,3,44,80,70,10,0,0,0,6415,147,6268,6415,3168,3247,6036,42,133,022910
42,022920,0000016016350,00003872,1558,1558,0,1558,1524,34,3872,3872,0,0,3872,3850,3780,23,13,28,1,5,22,22,0,0,0,0,3872,37,3835,3872,1933,1939,3780,42,133,022920
42,023000,0000002541478,00005109,2163,2163,0,2163,2059,104,5109,5109,0,0,5109,5040,4937,45,9,20,5,24,69,65,4,0,0,0,5109,90,5019,5109,2443,2666,4937,42,133,023000
42,023100,0000003324870,00006149,2729,2729,0,2729,2575,154,6149,6149,0,0,6149,6072,5972,37,15,25,3,20,77,70,6,1,0,0,6149,56,6093,6149,2962,3187,5972,42,133,023100
42,023200,0000033527548,00005457,2144,2144,0,2144,2061,83,5457,5457,0,0,5457,5430,5376,18,5,20,0,11,27,26,1,0,0,0,5457,41,5416,5457,2701,2756,5376,42,133,023200
42,023300,0000038266645,00008681,3465,3465,0,3465,3329,136,8681,8681,0,0,8681,8627,8492,40,8,62,5,20,54,54,0,0,0,0,8681,85,8596,8681,4271,4410,8492,42,133,023300
42,023400,0000049584828,00004441,2034,2034,0,2034,1881,153,4441,4441,0,0,4441,4403,4328,34,7,17,1,16,38,38,0,0,0,0,4441,45,4396,4441,2230,2211,4328,42,133,023400
42,023500,0000025501979,00005244,2226,2226,0,2226,2136,90,5244,5244,0,0,5244,5199,5116,39,3,20,1,20,45,42,3,0,0,0,5244,75,5169,5244,2588,2656,5116,42,133,023500
42,023600,0000066315099,00008322,3429,3429,0,3429,3144,285,8322,8322,0,0,8322,8270,8213,11,8,9,0,29,52,47,5,0,0,0,8322,95,8227,8322,4173,4149,8213,42,133,023600
42,023710,0000055842981,00003502,1381,1381,0,1381,1322,59,3502,3502,0,0,3502,3476,3450,12,3,8,0,3,26,22,4,0,0,0,3502,14,3488,3502,1774,1728,3450,42,133,023710
42,023720,0000233470477,00008872,3426,3426,0,3426,3183,243,8872,8872,0,0,8872,8824,8689,51,27,38,2,17,48,48,0,0,0,0,8872,52,8820,8872,4516,4356,8689,42,133,023720
42,023810,0000053027042,00004443,1747,1747,0,1747,1679,68,4443,4443,0,0,4443,4425,4369,31,3,18,1,3,18,18,0,0,0,0,4443,27,4416,4443,2231,2212,4369,42,133,023810
42,023821,0000012897433,00004494,1710,1710,0,1710,1653,57,4494,4494,0,0,4494,4453,4345,32,11,56,1,8,41,37,4,0,0,0,4494,26,4468,4494,2153,2341,4345,42,133,023821
42,023822,0000023324718,00006009,2325,2325,0,2325,2271,54,6009,6009,0,0,6009,5982,5891,32,7,34,5,13,27,27,0,0,0,0,6009,62,5947,6009,2953,3056,5891,42,133,023822
42,023900,0000129912005,00009541,3545,3545,0,3545,3388,157,9541,9541,0,0,9541,9486,9329,85,11,39,1,21,55,50,3,2,0,0,9541,84,9457,9541,4778,4763,9329,42,133,023900
42,024000,0000150626831,00008343,3368,3368,0,3368,2952,416,8343,8343,0,0,8343,8301,8114,118,25,27,0,17,42,42,0,0,0,0,8343,39,8304,8343,4219,4124,8114,42,133,024000
